idGame,slugTeam,idTeam,fgm,fga,pctFG,fg3m,fg3a,pctFG3,pctFT,fg2m,fg2a,pctFG2,teamName,cityTeam,minExact,ftm,fta,oreb,dreb,treb,ast,stl,blk,tov,pf,pts,plusminus
22000001,GSW,1610612744,37,99,0.374,10,33,0.303030303,0.652,27,66,0.409090909,Warriors,Golden State,240,15,23,13,34,47,26,6,6,18,24,99,-26
22000001,BKN,1610612751,42,92,0.457,15,35,0.428571429,0.813,27,57,0.473684211,Nets,Brooklyn,240,26,32,13,44,57,24,11,7,20,22,125,26
22000002,LAL,1610612747,38,81,0.469,9,29,0.310344828,0.774,29,52,0.557692308,Lakers,Los Angeles,240,24,31,8,37,45,22,4,2,19,20,109,-7
22000002,LAC,1610612746,44,93,0.473,14,40,0.35,0.737,30,53,0.566037736,Clippers,LA,240,14,19,11,29,40,22,10,3,16,29,116,7
22000003,MIL,1610612749,46,90,0.511,14,35,0.4,0.833,32,55,0.581818182,Bucks,Milwaukee,240,15,18,11,41,52,19,4,6,16,20,121,-1
22000003,BOS,1610612738,48,101,0.475,18,40,0.45,0.727,30,61,0.491803279,Celtics,Boston,240,8,11,10,27,37,23,8,6,6,17,122,1
22000004,PHX,1610612756,38,79,0.481,11,30,0.366666667,0.704,27,49,0.551020408,Suns,Phoenix,240,19,27,6,42,48,21,7,7,18,26,106,4
22000004,DAL,1610612742,36,85,0.424,9,37,0.243243243,0.808,27,48,0.5625,Mavericks,Dallas,240,21,26,6,33,39,17,6,0,11,23,102,-4
22000005,NOP,1610612740,31,78,0.397,10,35,0.285714286,0.788,21,43,0.488372093,Pelicans,New Orleans,240,26,33,11,30,41,18,8,2,19,20,98,-13
22000005,MIA,1610612748,38,75,0.507,16,37,0.432432432,0.826,22,38,0.578947368,Heat,Miami,240,19,23,4,31,35,29,11,2,17,25,111,13
22000006,MIL,1610612749,50,90,0.556,20,36,0.555555556,0.692,30,54,0.555555556,Bucks,Milwaukee,240,18,26,11,49,60,25,6,4,17,17,138,39
22000006,GSW,1610612744,34,99,0.343,10,45,0.222222222,0.84,24,54,0.444444444,Warriors,Golden State,240,21,25,10,33,43,14,5,6,11,22,99,-39
22000007,BOS,1610612738,37,98,0.378,8,27,0.296296296,0.684,29,71,0.408450704,Celtics,Boston,240,13,19,20,27,47,23,6,5,15,27,95,-28
22000007,BKN,1610612751,41,76,0.539,15,29,0.517241379,0.839,26,47,0.553191489,Nets,Brooklyn,240,26,31,9,34,43,21,5,10,15,22,123,28
22000008,LAL,1610612747,51,91,0.56,19,39,0.487179487,0.708,32,52,0.615384615,Lakers,Los Angeles,240,17,24,17,36,53,33,9,4,16,23,138,23
22000008,DAL,1610612742,41,83,0.494,13,32,0.40625,0.769,28,51,0.549019608,Mavericks,Dallas,240,20,26,3,24,27,20,13,3,9,22,115,-23
22000009,LAC,1610612746,41,74,0.554,19,38,0.5,0.833,22,36,0.611111111,Clippers,LA,240,20,24,9,29,38,32,9,4,18,32,121,13
22000009,DEN,1610612743,37,81,0.457,11,36,0.305555556,0.742,26,45,0.577777778,Nuggets,Denver,240,23,31,10,22,32,25,7,1,13,20,108,-13
22000010,CLE,1610612739,46,87,0.529,14,30,0.466666667,0.75,32,57,0.561403509,Cavaliers,Cleveland,240,15,20,10,40,50,34,12,3,18,22,121,7
22000010,CHA,1610612766,45,90,0.5,16,44,0.363636364,0.533,29,46,0.630434783,Hornets,Charlotte,240,8,15,8,24,32,29,10,4,15,17,114,-7
22000011,NYK,1610612752,39,85,0.459,12,28,0.428571429,0.739,27,57,0.473684211,Knicks,New York,240,17,23,5,35,40,25,8,8,16,27,107,-14
22000011,IND,1610612754,46,94,0.489,8,34,0.235294118,0.724,38,60,0.633333333,Pacers,Indiana,240,21,29,10,40,50,28,6,9,13,24,121,14
22000012,ORL,1610612753,42,88,0.477,10,28,0.357142857,0.633,32,60,0.533333333,Magic,Orlando,240,19,30,11,30,41,23,15,3,17,19,113,6
22000012,MIA,1610612748,42,83,0.506,7,20,0.35,0.842,35,63,0.555555556,Heat,Miami,240,16,19,7,36,43,25,11,2,22,21,107,-6
22000013,WAS,1610612764,39,85,0.459,13,27,0.481481481,0.696,26,58,0.448275862,Wizards,Washington,240,16,23,5,35,40,28,7,4,19,26,107,-6
22000013,PHI,1610612755,41,87,0.471,8,28,0.285714286,0.767,33,59,0.559322034,76ers,Philadelphia,240,23,30,10,37,47,22,11,8,16,25,113,6
22000014,TOR,1610612761,38,89,0.427,14,46,0.304347826,0.75,24,43,0.558139535,Raptors,Toronto,240,9,12,7,28,35,26,10,5,20,22,99,-14
22000014,NOP,1610612740,42,80,0.525,19,42,0.452380952,0.5,23,38,0.605263158,Pelicans,New Orleans,240,10,20,8,37,45,30,13,7,24,17,113,14
22000015,CHI,1610612741,36,87,0.414,8,35,0.228571429,0.857,28,52,0.538461538,Bulls,Chicago,240,24,28,8,29,37,20,10,3,15,22,104,-20
22000015,ATL,1610612737,43,80,0.537,14,35,0.4,0.828,29,45,0.644444444,Hawks,Atlanta,240,24,29,8,38,46,24,6,3,21,29,124,20
22000016,OKC,1610612760,42,91,0.462,13,39,0.333333333,0.68,29,52,0.557692308,Thunder,Oklahoma City,240,17,25,19,33,52,22,8,2,16,21,114,2
22000016,HOU,1610612745,39,79,0.494,14,38,0.368421053,0.741,25,41,0.609756098,Rockets,Houston,240,20,27,8,30,38,22,7,4,16,20,112,-2
22000017,SAS,1610612759,48,95,0.505,10,25,0.4,0.862,38,70,0.542857143,Spurs,San Antonio,240,25,29,8,40,48,28,8,8,10,18,131,12
22000017,MEM,1610612763,49,95,0.516,10,27,0.37037037,0.611,39,68,0.573529412,Grizzlies,Memphis,240,11,18,5,37,42,27,6,8,11,20,119,-12
22000018,MIN,1610612750,38,88,0.432,11,41,0.268292683,0.857,27,47,0.574468085,Timberwolves,Minnesota,240,24,28,12,36,48,25,6,5,11,16,111,10
22000018,DET,1610612765,45,93,0.484,8,35,0.228571429,0.375,37,58,0.637931034,Pistons,Detroit,240,3,8,7,37,44,29,5,2,12,20,101,-10
22000019,SAC,1610612758,45,102,0.441,10,31,0.322580645,0.774,35,71,0.492957746,Kings,Sacramento,265,24,31,18,36,54,27,5,7,14,29,124,2
22000019,DEN,1610612743,47,98,0.48,8,29,0.275862069,0.833,39,69,0.565217391,Nuggets,Denver,265,20,24,10,36,46,28,6,11,15,25,122,-2
22000020,UTA,1610612762,43,94,0.457,19,50,0.38,0.789,24,44,0.545454545,Jazz,Utah,240,15,19,12,47,59,24,3,3,11,16,120,20
22000020,POR,1610612757,37,92,0.402,12,33,0.363636364,0.824,25,59,0.423728814,Trail Blazers,Portland,240,14,17,6,34,40,23,6,3,6,18,100,-20
22000021,MEM,1610612763,37,93,0.398,13,43,0.302325581,0.862,24,50,0.48,Grizzlies,Memphis,240,25,29,9,37,46,20,5,6,10,27,112,-10
22000021,ATL,1610612737,38,89,0.427,13,36,0.361111111,0.868,25,53,0.471698113,Hawks,Atlanta,240,33,38,13,41,54,23,4,5,15,20,122,10
22000022,OKC,1610612760,40,88,0.455,10,36,0.277777778,0.792,30,52,0.576923077,Thunder,Oklahoma City,240,19,24,9,45,54,25,10,7,16,21,109,2
22000022,CHA,1610612766,37,93,0.398,13,32,0.40625,0.625,24,61,0.393442623,Hornets,Charlotte,240,20,32,13,34,47,27,11,8,13,22,107,-2
22000023,DET,1610612765,40,98,0.408,16,45,0.355555556,0.719,24,53,0.452830189,Pistons,Detroit,290,23,32,10,47,57,24,9,5,22,20,119,-9
22000023,CLE,1610612739,48,99,0.485,13,30,0.433333333,0.633,35,69,0.507246377,Cavaliers,Cleveland,290,19,30,7,44,51,29,13,4,18,24,128,9
22000024,WAS,1610612764,46,95,0.484,13,37,0.351351351,0.536,33,58,0.568965517,Wizards,Washington,240,15,28,7,36,43,28,5,3,14,25,120,-10
22000024,ORL,1610612753,48,95,0.505,11,31,0.35483871,0.793,37,64,0.578125,Magic,Orlando,240,23,29,11,43,54,25,8,0,13,21,130,10
22000025,PHI,1610612755,41,88,0.466,11,31,0.35483871,0.727,30,57,0.526315789,76ers,Philadelphia,240,16,22,12,35,47,20,9,6,12,19,109,20
22000025,NYK,1610612752,32,83,0.386,8,29,0.275862069,0.739,24,54,0.444444444,Knicks,New York,240,17,23,13,30,43,19,6,4,16,23,89,-20
22000026,IND,1610612754,52,93,0.559,9,26,0.346153846,0.632,43,67,0.641791045,Pacers,Indiana,240,12,19,9,40,49,34,15,4,16,26,125,19
22000026,CHI,1610612741,34,91,0.374,16,39,0.41025641,0.88,18,52,0.346153846,Bulls,Chicago,240,22,25,13,28,41,23,7,7,20,16,106,-19
22000027,TOR,1610612761,44,96,0.458,15,41,0.365853659,0.733,29,55,0.527272727,Raptors,Toronto,240,11,15,10,36,46,32,8,9,11,23,114,-5
22000027,SAS,1610612759,47,100,0.47,14,34,0.411764706,0.688,33,66,0.5,Spurs,San Antonio,240,11,16,14,39,53,36,4,3,16,20,119,5
22000028,UTA,1610612762,36,94,0.383,10,34,0.294117647,0.784,26,60,0.433333333,Jazz,Utah,240,29,37,19,38,57,15,5,4,18,20,111,-5
22000028,MIN,1610612750,45,101,0.446,13,29,0.448275862,0.722,32,72,0.444444444,Timberwolves,Minnesota,240,13,18,12,28,40,21,9,5,9,28,116,5
22000029,POR,1610612757,47,102,0.461,19,45,0.422222222,0.652,28,57,0.49122807,Trail Blazers,Portland,265,15,23,11,34,45,27,10,5,13,20,128,2
22000029,HOU,1610612745,45,87,0.517,11,35,0.314285714,0.781,34,52,0.653846154,Rockets,Houston,265,25,32,10,32,42,27,5,5,16,22,126,-2
22000030,SAC,1610612758,39,86,0.453,5,23,0.217391304,0.697,34,63,0.53968254,Kings,Sacramento,240,23,33,15,41,56,20,4,9,18,22,106,3
22000030,PHX,1610612756,41,98,0.418,11,44,0.25,0.769,30,54,0.555555556,Suns,Phoenix,240,10,13,10,30,40,25,8,5,11,23,103,-3
22000031,LAC,1610612746,26,76,0.342,4,33,0.121212121,0.85,22,43,0.511627907,Clippers,LA,240,17,20,5,31,36,13,2,2,12,19,73,-51
22000031,DAL,1610612742,43,87,0.494,14,41,0.341463415,0.889,29,46,0.630434783,Mavericks,Dallas,240,24,27,11,43,54,25,10,2,6,14,124,51
22000032,CHA,1610612766,43,96,0.448,10,34,0.294117647,0.588,33,62,0.532258065,Hornets,Charlotte,240,10,17,13,39,52,35,8,3,12,25,106,2
22000032,BKN,1610612751,35,82,0.427,17,47,0.361702128,0.68,18,35,0.514285714,Nets,Brooklyn,240,17,25,6,40,46,23,4,5,19,17,104,-2
22000033,WAS,1610612764,47,97,0.485,8,32,0.25,0.846,39,65,0.6,Wizards,Washington,240,11,13,13,34,47,27,6,4,13,26,113,-7
22000033,ORL,1610612753,37,85,0.435,9,25,0.36,0.974,28,60,0.466666667,Magic,Orlando,240,37,38,11,34,45,19,6,3,10,14,120,7
22000034,SAS,1610612759,38,89,0.427,11,36,0.305555556,1,27,53,0.509433962,Spurs,San Antonio,240,8,8,4,43,47,26,5,10,15,23,95,-3
22000034,NOP,1610612740,36,94,0.383,5,24,0.208333333,0.724,31,70,0.442857143,Pelicans,New Orleans,240,21,29,13,43,56,15,11,4,8,16,98,3
22000035,PHI,1610612755,33,79,0.418,12,37,0.324324324,0.727,21,42,0.5,76ers,Philadelphia,240,16,22,8,31,39,24,9,5,21,19,94,-24
22000035,CLE,1610612739,48,91,0.527,9,23,0.391304348,0.813,39,68,0.573529412,Cavaliers,Cleveland,240,13,16,11,34,45,31,13,6,16,22,118,24
22000036,NYK,1610612752,46,85,0.541,16,27,0.592592593,0.815,30,58,0.517241379,Knicks,New York,240,22,27,8,38,46,27,5,4,15,23,130,20
22000036,MIL,1610612749,41,95,0.432,7,38,0.184210526,0.724,34,57,0.596491228,Bucks,Milwaukee,240,21,29,17,27,44,24,7,5,11,21,110,-20
22000037,IND,1610612754,45,88,0.511,7,26,0.269230769,0.733,38,62,0.612903226,Pacers,Indiana,240,11,15,8,29,37,23,11,7,16,20,108,1
22000037,BOS,1610612738,40,79,0.506,9,23,0.391304348,0.75,31,56,0.553571429,Celtics,Boston,240,18,24,6,34,40,21,13,7,18,17,107,-1
22000038,GSW,1610612744,42,104,0.404,18,47,0.382978723,0.9,24,57,0.421052632,Warriors,Golden State,240,27,30,10,31,41,25,17,4,12,23,129,1
22000038,CHI,1610612741,44,86,0.512,17,41,0.414634146,0.742,27,45,0.6,Bulls,Chicago,240,23,31,7,47,54,27,4,6,24,21,128,-1
22000039,SAC,1610612758,36,76,0.474,10,23,0.434782609,0.72,26,53,0.490566038,Kings,Sacramento,240,18,25,3,36,39,21,5,4,15,23,100,-16
22000039,PHX,1610612756,46,94,0.489,14,35,0.4,0.909,32,59,0.542372881,Suns,Phoenix,240,10,11,8,36,44,34,6,3,9,20,116,16
22000040,MIN,1610612750,38,103,0.369,6,35,0.171428571,0.643,32,68,0.470588235,Timberwolves,Minnesota,240,9,14,17,31,48,24,11,6,17,24,91,-36
22000040,LAL,1610612747,50,90,0.556,13,35,0.371428571,0.778,37,55,0.672727273,Lakers,Los Angeles,240,14,18,5,41,46,32,6,14,17,19,127,36
22000041,DET,1610612765,43,98,0.439,13,41,0.317073171,0.875,30,57,0.526315789,Pistons,Detroit,240,21,24,17,31,48,24,7,4,8,25,120,-8
22000041,ATL,1610612737,40,82,0.488,20,42,0.476190476,0.875,20,40,0.5,Hawks,Atlanta,240,28,32,8,37,45,30,5,7,13,22,128,8
22000042,MEM,1610612763,42,98,0.429,10,29,0.344827586,0.759,32,69,0.463768116,Grizzlies,Memphis,265,22,29,16,40,56,20,10,4,19,17,116,5
22000042,BKN,1610612751,41,100,0.41,14,42,0.333333333,0.882,27,58,0.465517241,Nets,Brooklyn,265,15,17,13,37,50,28,13,6,17,20,111,-5
22000043,UTA,1610612762,43,86,0.5,13,36,0.361111111,0.786,30,50,0.6,Jazz,Utah,240,11,14,8,35,43,24,9,6,16,19,110,1
22000043,OKC,1610612760,40,86,0.465,15,38,0.394736842,0.737,25,48,0.520833333,Thunder,Oklahoma City,240,14,19,7,30,37,21,9,5,15,16,109,-1
22000044,HOU,1610612745,39,86,0.453,16,39,0.41025641,0.739,23,47,0.489361702,Rockets,Houston,240,17,23,5,33,38,25,8,3,15,25,111,-13
22000044,DEN,1610612743,46,87,0.529,14,31,0.451612903,0.563,32,56,0.571428571,Nuggets,Denver,240,18,32,11,41,52,31,8,7,14,18,124,13
22000045,POR,1610612757,43,92,0.467,16,46,0.347826087,0.867,27,46,0.586956522,Trail Blazers,Portland,240,13,15,7,38,45,27,9,6,9,16,115,8
22000045,LAL,1610612747,41,87,0.471,10,27,0.37037037,0.833,31,60,0.516666667,Lakers,Los Angeles,240,15,18,6,35,41,20,6,5,14,14,107,-8
22000046,NYK,1610612752,34,79,0.43,14,25,0.56,0.619,20,54,0.37037037,Knicks,New York,240,13,21,14,41,55,23,9,6,25,21,95,9
22000046,CLE,1610612739,32,88,0.364,7,32,0.21875,0.682,25,56,0.446428571,Cavaliers,Cleveland,240,15,22,14,29,43,22,13,10,13,17,86,-9
22000047,GSW,1610612744,38,76,0.5,14,33,0.424242424,0.722,24,43,0.558139535,Warriors,Golden State,240,26,36,4,36,40,21,8,8,19,28,116,10
22000047,DET,1610612765,35,92,0.38,13,35,0.371428571,0.793,22,57,0.385964912,Pistons,Detroit,240,23,29,16,29,45,21,8,6,15,26,106,-10
22000048,IND,1610612754,43,84,0.512,12,33,0.363636364,0.813,31,51,0.607843137,Pacers,Indiana,240,13,16,4,32,36,27,9,5,14,25,111,-5
22000048,BOS,1610612738,40,80,0.5,9,22,0.409090909,0.73,31,58,0.534482759,Celtics,Boston,240,27,37,12,31,43,21,10,3,14,16,116,5
22000049,TOR,1610612761,32,90,0.356,17,45,0.377777778,0.857,15,45,0.333333333,Raptors,Toronto,240,12,14,10,37,47,21,12,7,19,28,93,-7
22000049,PHI,1610612755,32,84,0.381,8,31,0.258064516,0.848,24,53,0.452830189,76ers,Philadelphia,240,28,33,9,45,54,21,10,10,18,15,100,7
22000050,WAS,1610612764,37,84,0.44,10,37,0.27027027,0.885,27,47,0.574468085,Wizards,Washington,240,23,26,8,39,47,25,6,6,19,28,107,-8
22000050,CHI,1610612741,38,87,0.437,15,36,0.416666667,0.75,23,51,0.450980392,Bulls,Chicago,240,24,32,5,32,37,26,7,1,14,23,115,8
22000051,MIL,1610612749,51,92,0.554,29,51,0.568627451,0.867,22,41,0.536585366,Bucks,Milwaukee,240,13,15,10,35,45,32,14,2,17,22,144,47
22000051,MIA,1610612748,37,79,0.468,11,37,0.297297297,0.667,26,42,0.619047619,Heat,Miami,240,12,18,3,27,30,23,9,6,21,18,97,-47
22000052,ORL,1610612753,49,96,0.51,7,22,0.318181818,0.813,42,74,0.567567568,Magic,Orlando,240,13,16,12,34,46,26,12,2,11,23,118,11
22000052,OKC,1610612760,43,87,0.494,11,34,0.323529412,0.526,32,53,0.603773585,Thunder,Oklahoma City,240,10,19,10,37,47,20,3,7,20,18,107,-11
22000053,PHX,1610612756,37,84,0.44,19,47,0.404255319,0.947,18,37,0.486486486,Suns,Phoenix,240,18,19,12,31,43,24,7,4,10,18,111,25
22000053,NOP,1610612740,37,77,0.481,3,24,0.125,0.5,34,53,0.641509434,Pelicans,New Orleans,240,9,18,7,34,41,18,8,3,16,14,86,-25
22000054,MIN,1610612750,37,89,0.416,13,38,0.342105263,0.824,24,51,0.470588235,Timberwolves,Minnesota,240,14,17,11,28,39,22,7,6,14,15,101,-23
22000054,LAC,1610612746,47,88,0.534,16,31,0.516129032,0.875,31,57,0.543859649,Clippers,LA,240,14,16,7,39,46,32,6,10,13,21,124,23
22000055,SAC,1610612758,46,94,0.489,16,33,0.484848485,0.773,30,61,0.491803279,Kings,Sacramento,240,17,22,12,25,37,33,9,2,10,18,125,10
22000055,DEN,1610612743,44,81,0.543,11,28,0.392857143,0.8,33,53,0.622641509,Nuggets,Denver,240,16,20,7,32,39,27,7,5,19,18,115,-10
22000056,MEM,1610612763,40,93,0.43,9,33,0.272727273,0.72,31,60,0.516666667,Grizzlies,Memphis,240,18,25,14,32,46,26,8,3,22,13,107,-19
22000056,BOS,1610612738,49,91,0.538,16,39,0.41025641,0.857,33,52,0.634615385,Celtics,Boston,240,12,14,10,32,42,27,17,11,16,21,126,19
22000057,BKN,1610612751,54,100,0.54,19,41,0.463414634,0.783,35,59,0.593220339,Nets,Brooklyn,240,18,23,9,31,40,30,6,3,8,24,145,4
22000057,ATL,1610612737,47,99,0.475,18,46,0.391304348,0.829,29,53,0.547169811,Hawks,Atlanta,240,29,35,17,37,54,27,5,2,12,19,141,-4
22000058,MIL,1610612749,40,102,0.392,16,41,0.390243902,0.923,24,61,0.393442623,Bucks,Milwaukee,240,12,13,16,31,47,26,14,6,13,25,108,-11
22000058,MIA,1610612748,40,82,0.488,15,39,0.384615385,0.828,25,43,0.581395349,Heat,Miami,240,24,29,10,42,52,25,5,5,22,18,119,11
22000059,DAL,1610612742,34,87,0.391,12,42,0.285714286,0.576,22,45,0.488888889,Mavericks,Dallas,240,19,33,13,26,39,24,10,6,14,16,99,-19
22000059,CHA,1610612766,43,84,0.512,15,34,0.441176471,0.81,28,50,0.56,Hornets,Charlotte,240,17,21,12,38,50,30,6,6,23,28,118,19
22000060,SAS,1610612759,40,87,0.46,10,24,0.416666667,0.739,30,63,0.476190476,Spurs,San Antonio,240,17,23,7,32,39,25,8,4,10,18,107,-14
22000060,LAL,1610612747,46,82,0.561,14,26,0.538461538,0.75,32,56,0.571428571,Lakers,Los Angeles,240,15,20,7,40,47,25,4,3,17,24,121,14
22000061,POR,1610612757,32,76,0.421,12,38,0.315789474,0.853,20,38,0.526315789,Trail Blazers,Portland,240,29,34,5,36,41,14,5,4,17,17,105,-23
22000061,LAC,1610612746,47,95,0.495,18,38,0.473684211,0.727,29,57,0.50877193,Clippers,LA,240,16,22,11,36,47,30,13,6,10,25,128,23
22000062,IND,1610612754,42,87,0.483,16,35,0.457142857,0.792,26,52,0.5,Pacers,Indiana,240,19,24,9,35,44,28,12,1,14,22,119,20
22000062,CLE,1610612739,37,82,0.451,12,23,0.52173913,0.542,25,59,0.423728814,Cavaliers,Cleveland,240,13,24,11,32,43,22,5,6,18,22,99,-20
22000063,WAS,1610612764,42,84,0.5,14,29,0.482758621,0.78,28,55,0.509090909,Wizards,Washington,240,32,41,9,28,37,27,8,4,14,27,130,-3
22000063,CHI,1610612741,50,92,0.543,14,36,0.388888889,0.76,36,56,0.642857143,Bulls,Chicago,240,19,25,9,35,44,34,9,3,15,27,133,3
22000064,PHI,1610612755,44,91,0.484,15,33,0.454545455,0.867,29,58,0.5,76ers,Philadelphia,240,13,15,7,47,54,23,7,10,14,23,116,24
22000064,ORL,1610612753,33,95,0.347,7,28,0.25,0.905,26,67,0.388059701,Magic,Orlando,240,19,21,10,38,48,17,2,5,11,15,92,-24
22000065,SAC,1610612758,45,96,0.469,11,33,0.333333333,0.75,34,63,0.53968254,Kings,Sacramento,240,18,24,14,31,45,23,11,5,15,21,119,-3
22000065,HOU,1610612745,45,86,0.523,13,36,0.361111111,0.76,32,50,0.64,Rockets,Houston,240,19,25,10,35,45,26,10,6,18,14,122,3
22000066,TOR,1610612761,34,83,0.41,17,52,0.326923077,0.714,17,31,0.548387097,Raptors,Toronto,240,15,21,9,44,53,21,7,6,16,22,100,17
22000066,NYK,1610612752,32,88,0.364,3,36,0.083333333,0.8,29,52,0.557692308,Knicks,New York,240,16,20,9,39,48,21,6,3,15,21,83,-17
22000067,OKC,1610612760,30,80,0.375,15,48,0.3125,0.333,15,32,0.46875,Thunder,Oklahoma City,240,5,15,7,33,40,24,6,3,19,20,80,-33
22000067,NOP,1610612740,44,91,0.484,13,36,0.361111111,0.632,31,55,0.563636364,Pelicans,New Orleans,240,12,19,14,44,58,23,9,4,13,16,113,33
22000068,UTA,1610612762,35,84,0.417,12,34,0.352941176,0.684,23,50,0.46,Jazz,Utah,240,13,19,10,36,46,16,8,3,13,15,95,-11
22000068,PHX,1610612756,41,84,0.488,17,33,0.515151515,0.7,24,51,0.470588235,Suns,Phoenix,240,7,10,5,36,41,26,5,6,15,17,106,11
22000069,MEM,1610612763,43,90,0.478,14,39,0.358974359,0.8,29,51,0.568627451,Grizzlies,Memphis,240,8,10,10,38,48,34,10,6,15,18,108,15
22000069,CHA,1610612766,35,86,0.407,9,31,0.290322581,0.667,26,55,0.472727273,Hornets,Charlotte,240,14,21,10,32,42,23,9,4,18,15,93,-15
22000070,DET,1610612765,36,88,0.409,11,34,0.323529412,0.65,25,54,0.462962963,Pistons,Detroit,240,13,20,12,36,48,18,9,2,19,16,96,3
22000070,BOS,1610612738,39,83,0.47,8,31,0.258064516,0.5,31,52,0.596153846,Celtics,Boston,240,7,14,7,37,44,20,12,11,19,20,93,-3
22000071,MIA,1610612748,29,78,0.372,7,33,0.212121212,0.72,22,45,0.488888889,Heat,Miami,240,18,25,5,36,41,20,10,2,14,24,83,-10
22000071,DAL,1610612742,32,78,0.41,12,37,0.324324324,0.739,20,41,0.487804878,Mavericks,Dallas,240,17,23,4,45,49,18,9,3,16,25,93,10
22000072,BKN,1610612751,35,86,0.407,7,37,0.189189189,0.826,28,49,0.571428571,Nets,Brooklyn,240,19,23,10,35,45,19,6,6,15,16,96,-18
22000072,ATL,1610612737,43,93,0.462,16,39,0.41025641,0.857,27,54,0.5,Hawks,Atlanta,240,12,14,10,38,48,24,8,3,9,20,114,18
22000073,MIL,1610612749,42,85,0.494,22,45,0.488888889,0.667,20,40,0.5,Bucks,Milwaukee,240,20,30,5,39,44,27,16,6,17,19,126,30
22000073,CHI,1610612741,38,87,0.437,6,26,0.230769231,0.7,32,61,0.524590164,Bulls,Chicago,240,14,20,6,36,42,18,10,6,20,21,96,-30
22000074,WAS,1610612764,49,89,0.551,16,33,0.484848485,0.762,33,56,0.589285714,Wizards,Washington,240,16,21,8,35,43,35,9,3,16,19,130,21
22000074,MIN,1610612750,42,88,0.477,13,36,0.361111111,0.571,29,52,0.557692308,Timberwolves,Minnesota,240,12,21,11,32,43,17,9,3,20,22,109,-21
22000075,SAS,1610612759,36,85,0.424,13,34,0.382352941,0.692,23,51,0.450980392,Spurs,San Antonio,240,18,26,8,37,45,23,3,8,13,20,103,-6
22000075,LAL,1610612747,41,101,0.406,14,33,0.424242424,0.813,27,68,0.397058824,Lakers,Los Angeles,240,13,16,16,42,58,27,8,7,13,20,109,6
22000076,PHX,1610612756,37,76,0.487,13,35,0.371428571,0.905,24,41,0.585365854,Suns,Phoenix,240,19,21,8,29,37,24,1,4,17,20,106,3
22000076,DEN,1610612743,39,86,0.453,12,29,0.413793103,0.813,27,57,0.473684211,Nuggets,Denver,240,13,16,8,30,38,28,7,1,11,25,103,-3
22000077,UTA,1610612762,41,89,0.461,15,42,0.357142857,0.643,26,47,0.553191489,Jazz,Utah,240,9,14,13,33,46,28,3,3,13,20,106,6
22000077,LAC,1610612746,33,85,0.388,13,33,0.393939394,0.875,20,52,0.384615385,Clippers,LA,240,21,24,12,31,43,19,6,8,8,16,100,-6
22000078,POR,1610612757,40,92,0.435,20,43,0.465116279,0.767,20,49,0.408163265,Trail Blazers,Portland,240,23,30,8,43,51,23,11,3,10,27,123,25
22000078,GSW,1610612744,31,79,0.392,7,35,0.2,0.879,24,44,0.545454545,Warriors,Golden State,240,29,33,3,41,44,19,4,9,15,28,98,-25
22000079,SAC,1610612758,35,90,0.389,9,28,0.321428571,0.714,26,62,0.419354839,Kings,Sacramento,240,15,21,14,33,47,11,5,4,14,21,94,-8
22000079,HOU,1610612745,36,81,0.444,13,41,0.317073171,0.739,23,40,0.575,Rockets,Houston,240,17,23,6,42,48,15,10,10,13,22,102,8
22000080,NYK,1610612752,42,83,0.506,12,27,0.444444444,0.769,30,56,0.535714286,Knicks,New York,240,10,13,10,41,51,23,4,3,15,16,106,4
22000080,IND,1610612754,34,84,0.405,19,50,0.38,0.833,15,34,0.441176471,Pacers,Indiana,240,15,18,5,27,32,22,6,4,8,21,102,-4
22000081,ORL,1610612753,40,108,0.37,10,38,0.263157895,0.75,30,70,0.428571429,Magic,Orlando,240,9,12,15,40,55,21,7,1,6,18,99,-9
22000081,OKC,1610612760,38,86,0.442,13,41,0.317073171,0.905,25,45,0.555555556,Thunder,Oklahoma City,240,19,21,6,46,52,22,5,5,10,17,108,9
22000082,PHI,1610612755,47,79,0.595,16,35,0.457142857,0.708,31,44,0.704545455,76ers,Philadelphia,240,17,24,7,38,45,35,10,7,21,17,127,15
22000082,CHA,1610612766,38,92,0.413,13,35,0.371428571,0.885,25,57,0.438596491,Hornets,Charlotte,240,23,26,14,26,40,34,15,5,12,18,112,-15
22000083,CLE,1610612739,38,91,0.418,7,29,0.24137931,0.765,31,62,0.5,Cavaliers,Cleveland,240,13,17,15,31,46,19,10,2,15,21,96,5
22000083,ATL,1610612737,35,85,0.412,11,32,0.34375,0.526,24,53,0.452830189,Hawks,Atlanta,240,10,19,15,33,48,22,9,5,20,20,91,-5
22000084,TOR,1610612761,38,91,0.418,14,48,0.291666667,0.963,24,43,0.558139535,Raptors,Toronto,240,26,27,10,30,40,21,6,4,9,29,116,-4
22000084,NOP,1610612740,35,83,0.422,14,38,0.368421053,0.766,21,45,0.466666667,Pelicans,New Orleans,240,36,47,14,36,50,26,6,7,12,18,120,4
22000085,DET,1610612765,41,86,0.477,16,36,0.444444444,0.88,25,50,0.5,Pistons,Detroit,240,22,25,8,25,33,29,8,7,9,16,120,-2
22000085,BOS,1610612738,49,87,0.563,15,33,0.454545455,0.692,34,54,0.62962963,Celtics,Boston,240,9,13,12,29,41,35,4,5,17,22,122,2
22000086,WAS,1610612764,43,104,0.413,12,33,0.363636364,0.735,31,71,0.436619718,Wizards,Washington,240,25,34,13,36,49,27,9,3,7,22,123,1
22000086,BKN,1610612751,40,81,0.494,14,32,0.4375,0.903,26,49,0.530612245,Nets,Brooklyn,240,28,31,7,44,51,25,5,9,20,24,122,-1
22000087,MEM,1610612763,39,95,0.411,9,33,0.272727273,0.875,30,62,0.483870968,Grizzlies,Memphis,240,7,8,14,36,50,23,6,3,11,18,94,-14
22000087,LAL,1610612747,41,89,0.461,12,35,0.342857143,0.737,29,54,0.537037037,Lakers,Los Angeles,240,14,19,12,37,49,24,9,5,10,15,108,14
22000088,MIN,1610612750,44,85,0.518,10,31,0.322580645,0.688,34,54,0.62962963,Timberwolves,Minnesota,240,11,16,9,27,36,30,11,6,14,17,109,-15
22000088,DEN,1610612743,45,92,0.489,19,45,0.422222222,0.714,26,47,0.553191489,Nuggets,Denver,240,15,21,13,30,43,34,6,4,15,11,124,15
22000089,UTA,1610612762,49,89,0.551,21,41,0.512195122,0.579,28,48,0.583333333,Jazz,Utah,240,11,19,9,48,57,29,4,11,19,18,130,21
22000089,SAS,1610612759,44,105,0.419,6,19,0.315789474,0.714,38,86,0.441860465,Spurs,San Antonio,240,15,21,14,31,45,23,13,4,7,16,109,-21
22000090,DAL,1610612742,39,89,0.438,11,42,0.261904762,0.704,28,47,0.595744681,Mavericks,Dallas,240,19,27,11,30,41,23,6,4,15,27,108,-10
22000090,CHI,1610612741,39,85,0.459,13,37,0.351351351,0.9,26,48,0.541666667,Bulls,Chicago,240,27,30,11,37,48,16,11,2,16,24,118,10
22000091,PHX,1610612756,37,75,0.493,10,33,0.303030303,0.821,27,42,0.642857143,Suns,Phoenix,240,23,28,7,33,40,23,4,3,13,22,107,-5
22000091,LAC,1610612746,40,83,0.482,17,29,0.586206897,0.789,23,54,0.425925926,Clippers,LA,240,15,19,8,29,37,24,5,2,10,22,112,5
22000092,POR,1610612757,41,98,0.418,14,43,0.325581395,0.788,27,55,0.490909091,Trail Blazers,Portland,240,26,33,12,28,40,16,7,2,12,27,122,-15
22000092,GSW,1610612744,49,88,0.557,13,34,0.382352941,0.765,36,54,0.666666667,Warriors,Golden State,240,26,34,11,42,53,23,4,7,15,24,137,15
22000093,ORL,1610612753,38,88,0.432,15,34,0.441176471,0.923,23,54,0.425925926,Magic,Orlando,240,12,13,18,36,54,22,9,7,19,15,103,20
22000093,CLE,1610612739,33,85,0.388,10,28,0.357142857,0.583,23,57,0.403508772,Cavaliers,Cleveland,240,7,12,9,26,35,20,12,4,14,14,83,-20
22000094,PHI,1610612755,46,95,0.484,11,32,0.34375,0.652,35,63,0.555555556,76ers,Philadelphia,240,15,23,14,41,55,34,7,5,10,21,118,17
22000094,CHA,1610612766,36,86,0.419,13,39,0.333333333,0.727,23,47,0.489361702,Hornets,Charlotte,240,16,22,8,39,47,30,4,4,16,24,101,-17
22000095,NYK,1610612752,43,85,0.506,7,21,0.333333333,0.8,36,64,0.5625,Knicks,New York,240,20,25,11,34,45,26,9,6,15,21,113,5
22000095,ATL,1610612737,40,87,0.46,10,31,0.322580645,0.783,30,56,0.535714286,Hawks,Atlanta,240,18,23,10,30,40,24,4,2,12,21,108,-5
22000096,OKC,1610612760,29,79,0.367,13,48,0.270833333,0.704,16,31,0.516129032,Thunder,Oklahoma City,240,19,27,6,32,38,20,6,4,15,15,90,-28
22000096,MIA,1610612748,46,81,0.568,16,34,0.470588235,0.556,30,47,0.638297872,Heat,Miami,240,10,18,4,43,47,34,7,0,14,20,118,28
22000097,TOR,1610612761,36,90,0.4,13,37,0.351351351,0.763,23,53,0.433962264,Raptors,Toronto,240,29,38,8,29,37,20,13,4,10,26,114,-12
22000097,BOS,1610612738,41,84,0.488,15,29,0.517241379,0.853,26,55,0.472727273,Celtics,Boston,240,29,34,12,44,56,19,3,9,19,29,126,12
22000098,HOU,1610612745,30,77,0.39,11,40,0.275,0.806,19,37,0.513513514,Rockets,Houston,240,29,36,7,28,35,17,5,4,12,19,100,-13
22000098,DAL,1610612742,39,82,0.476,16,39,0.41025641,0.95,23,43,0.534883721,Mavericks,Dallas,240,19,20,10,41,51,24,4,3,15,31,113,13
22000099,MIL,1610612749,49,85,0.576,14,34,0.411764706,0.813,35,51,0.68627451,Bucks,Milwaukee,240,13,16,7,42,49,32,6,4,19,18,125,10
22000099,DET,1610612765,43,98,0.439,17,40,0.425,1,26,58,0.448275862,Pistons,Detroit,240,12,12,6,25,31,27,9,5,8,17,115,-10
22000100,NOP,1610612740,44,101,0.436,9,27,0.333333333,0.792,35,74,0.472972973,Pelicans,New Orleans,265,19,24,16,41,57,26,5,4,18,20,116,-2
22000100,IND,1610612754,45,93,0.484,19,45,0.422222222,0.692,26,48,0.541666667,Pacers,Indiana,265,9,13,5,37,42,32,10,8,14,27,118,2
22000101,SAC,1610612758,34,90,0.378,10,35,0.285714286,0.718,24,55,0.436363636,Kings,Sacramento,240,28,39,11,41,52,20,5,6,14,20,106,-31
22000101,GSW,1610612744,51,97,0.526,23,43,0.534883721,0.857,28,54,0.518518519,Warriors,Golden State,240,12,14,3,45,48,41,4,6,11,28,137,31
22000102,UTA,1610612762,33,86,0.384,11,34,0.323529412,0.704,22,52,0.423076923,Jazz,Utah,240,19,27,9,32,41,17,6,3,15,18,96,-34
22000102,BKN,1610612751,52,93,0.559,14,36,0.388888889,0.75,38,57,0.666666667,Nets,Brooklyn,240,12,16,8,43,51,31,11,5,12,22,130,34
22000103,MEM,1610612763,36,87,0.414,10,26,0.384615385,0.769,26,61,0.426229508,Grizzlies,Memphis,240,10,13,5,33,38,24,14,4,13,14,92,-2
22000103,LAL,1610612747,38,87,0.437,9,31,0.290322581,0.818,29,56,0.517857143,Lakers,Los Angeles,240,9,11,9,43,52,24,7,8,17,14,94,2
22000104,MIN,1610612750,42,91,0.462,11,34,0.323529412,0.778,31,57,0.543859649,Timberwolves,Minnesota,240,21,27,10,32,42,24,8,4,14,31,116,-7
22000104,DEN,1610612743,41,79,0.519,8,25,0.32,0.733,33,54,0.611111111,Nuggets,Denver,240,33,45,10,32,42,22,9,2,14,27,123,7
22000105,SAS,1610612759,44,96,0.458,20,40,0.5,0.727,24,56,0.428571429,Spurs,San Antonio,240,8,11,11,33,44,23,9,3,10,13,116,3
22000105,LAC,1610612746,43,86,0.5,15,35,0.428571429,0.923,28,51,0.549019608,Clippers,LA,240,12,13,7,38,45,29,6,7,13,16,113,-3
22000106,POR,1610612757,39,94,0.415,19,51,0.37254902,0.647,20,43,0.465116279,Trail Blazers,Portland,240,11,17,10,36,46,23,8,3,11,16,108,-3
22000106,CHI,1610612741,40,91,0.44,16,41,0.390243902,0.833,24,50,0.48,Bulls,Chicago,240,15,18,11,41,52,27,5,5,15,19,111,3
22000107,IND,1610612754,42,89,0.472,9,23,0.391304348,0.808,33,66,0.5,Pacers,Indiana,240,21,26,7,31,38,21,10,9,9,21,114,7
22000107,HOU,1610612745,39,81,0.481,8,30,0.266666667,0.808,31,51,0.607843137,Rockets,Houston,240,21,26,5,34,39,19,7,12,16,22,107,-7
22000108,ORL,1610612753,40,81,0.494,12,29,0.413793103,0.722,28,52,0.538461538,Magic,Orlando,240,13,18,8,35,43,20,4,4,15,22,105,11
22000108,CLE,1610612739,36,85,0.424,4,26,0.153846154,0.692,32,59,0.542372881,Cavaliers,Cleveland,240,18,26,13,32,45,24,9,4,10,19,94,-11
22000109,WAS,1610612764,47,94,0.5,16,37,0.432432432,0.743,31,57,0.543859649,Wizards,Washington,240,26,35,9,26,35,27,9,2,13,27,136,-5
22000109,PHI,1610612755,50,81,0.617,18,29,0.620689655,0.697,32,52,0.615384615,76ers,Philadelphia,240,23,33,1,34,35,33,9,6,16,21,141,5
22000110,CHA,1610612766,32,85,0.376,11,36,0.305555556,0.818,21,49,0.428571429,Hornets,Charlotte,240,27,33,8,41,49,22,11,7,9,14,102,8
22000110,ATL,1610612737,36,96,0.375,7,40,0.175,0.833,29,56,0.517857143,Hawks,Atlanta,240,15,18,12,45,57,25,6,1,13,25,94,-8
22000111,MIA,1610612748,35,81,0.432,13,36,0.361111111,0.846,22,45,0.488888889,Heat,Miami,240,22,26,6,36,42,26,2,7,8,15,105,-2
22000111,BOS,1610612738,42,99,0.424,12,35,0.342857143,0.917,30,64,0.46875,Celtics,Boston,240,11,12,16,37,53,22,7,5,7,23,107,2
22000112,UTA,1610612762,40,91,0.44,14,44,0.318181818,0.545,26,47,0.553191489,Jazz,Utah,240,6,11,10,32,42,20,5,9,14,15,100,-12
22000112,NYK,1610612752,45,87,0.517,8,22,0.363636364,0.737,37,65,0.569230769,Knicks,New York,240,14,19,11,37,48,22,10,5,12,17,112,12
22000113,MIL,1610612749,49,90,0.544,19,43,0.441860465,0.619,30,47,0.638297872,Bucks,Milwaukee,240,13,21,9,38,47,35,5,4,14,22,130,15
22000113,DET,1610612765,38,97,0.392,13,41,0.317073171,0.867,25,56,0.446428571,Pistons,Detroit,240,26,30,15,32,47,20,6,3,9,20,115,-15
22000114,OKC,1610612760,40,87,0.46,19,46,0.413043478,0.75,21,41,0.512195122,Thunder,Oklahoma City,240,12,16,4,34,38,28,10,5,14,18,111,1
22000114,NOP,1610612740,44,89,0.494,4,22,0.181818182,0.783,40,67,0.597014925,Pelicans,New Orleans,240,18,23,9,43,52,25,11,0,15,18,110,-1
22000115,TOR,1610612761,39,79,0.494,14,35,0.4,0.719,25,44,0.568181818,Raptors,Toronto,240,23,32,10,32,42,18,6,5,12,19,115,-8
22000115,PHX,1610612756,40,83,0.482,21,40,0.525,0.917,19,43,0.441860465,Suns,Phoenix,240,22,24,8,33,41,30,4,3,10,23,123,8
22000116,LAC,1610612746,36,81,0.444,11,34,0.323529412,1,25,47,0.531914894,Clippers,LA,240,25,25,12,36,48,19,6,3,19,26,108,7
22000116,GSW,1610612744,39,86,0.453,8,30,0.266666667,0.789,31,56,0.553571429,Warriors,Golden State,240,15,19,8,27,35,25,10,2,13,21,101,-7
22000117,SAC,1610612758,47,91,0.516,14,37,0.378378378,0.741,33,54,0.611111111,Kings,Sacramento,240,20,27,12,27,39,30,8,3,7,16,128,4
22000117,CHI,1610612741,49,93,0.527,14,40,0.35,0.8,35,53,0.660377358,Bulls,Chicago,240,12,15,10,33,43,27,3,2,14,21,124,-4
22000118,PHI,1610612755,41,87,0.471,9,26,0.346153846,0.9,32,61,0.524590164,76ers,Philadelphia,240,18,20,4,43,47,23,6,6,20,25,109,-13
22000118,BKN,1610612751,44,97,0.454,15,37,0.405405405,0.655,29,60,0.483333333,Nets,Brooklyn,240,19,29,11,37,48,30,11,7,12,17,122,13
22000119,MEM,1610612763,36,83,0.434,11,31,0.35483871,0.875,25,52,0.480769231,Grizzlies,Memphis,240,7,8,11,37,48,27,13,6,18,17,90,-4
22000119,CLE,1610612739,36,79,0.456,13,30,0.433333333,0.563,23,49,0.469387755,Cavaliers,Cleveland,240,9,16,7,30,37,24,11,3,15,14,94,4
22000120,DEN,1610612743,43,97,0.443,15,44,0.340909091,0.762,28,53,0.528301887,Nuggets,Denver,265,16,21,9,38,47,25,8,1,13,27,117,-7
22000120,DAL,1610612742,42,87,0.483,16,40,0.4,0.774,26,47,0.553191489,Mavericks,Dallas,265,24,31,7,37,44,27,12,7,13,21,124,7
22000121,SAS,1610612759,43,92,0.467,16,35,0.457142857,0.941,27,57,0.473684211,Spurs,San Antonio,240,16,17,6,34,40,28,4,3,6,15,118,9
22000121,LAL,1610612747,43,86,0.5,10,30,0.333333333,0.619,33,56,0.589285714,Lakers,Los Angeles,240,13,21,9,39,48,21,2,4,13,20,109,-9
22000122,POR,1610612757,49,90,0.544,18,41,0.43902439,0.826,31,49,0.632653061,Trail Blazers,Portland,240,19,23,6,38,44,25,10,6,15,23,135,18
22000122,MIN,1610612750,39,93,0.419,14,41,0.341463415,0.758,25,52,0.480769231,Timberwolves,Minnesota,240,25,33,15,33,48,24,11,4,16,19,117,-18
22000123,PHX,1610612756,41,91,0.451,17,52,0.326923077,0.462,24,39,0.615384615,Suns,Phoenix,265,6,13,9,41,50,24,10,7,21,25,105,-5
22000123,DET,1610612765,37,90,0.411,11,34,0.323529412,0.862,26,56,0.464285714,Pistons,Detroit,265,25,29,9,37,46,23,13,4,14,14,110,5
22000124,WAS,1610612764,41,88,0.466,11,29,0.379310345,0.875,30,59,0.508474576,Wizards,Washington,240,14,16,7,31,38,22,9,4,17,24,107,-9
22000124,BOS,1610612738,41,86,0.477,12,32,0.375,0.733,29,54,0.537037037,Celtics,Boston,240,22,30,11,38,49,21,11,4,21,22,116,9
22000125,OKC,1610612760,38,87,0.437,11,34,0.323529412,0.667,27,53,0.509433962,Thunder,Oklahoma City,240,14,21,11,51,62,16,2,7,11,19,101,12
22000125,NYK,1610612752,34,96,0.354,9,27,0.333333333,0.6,25,69,0.362318841,Knicks,New York,240,12,20,11,38,49,19,8,7,4,19,89,-12
22000126,NOP,1610612740,38,77,0.494,15,38,0.394736842,0.731,23,39,0.58974359,Pelicans,New Orleans,240,19,26,10,26,36,29,6,4,19,17,110,-8
22000126,CHA,1610612766,41,87,0.471,16,42,0.380952381,0.8,25,45,0.555555556,Hornets,Charlotte,240,20,25,16,29,45,33,10,4,14,20,118,8
22000127,ORL,1610612753,34,89,0.382,8,29,0.275862069,0.875,26,60,0.433333333,Magic,Orlando,240,14,16,9,33,42,17,5,2,12,13,90,-42
22000127,HOU,1610612745,51,91,0.56,22,47,0.468085106,0.727,29,44,0.659090909,Rockets,Houston,240,8,11,7,42,49,34,6,8,8,18,132,42
22000128,MEM,1610612763,45,98,0.459,13,32,0.40625,0.857,32,66,0.484848485,Grizzlies,Memphis,240,12,14,12,34,46,29,14,6,12,18,115,5
22000128,BKN,1610612751,38,81,0.469,14,31,0.451612903,0.952,24,50,0.48,Nets,Brooklyn,240,20,21,4,38,42,26,6,4,20,13,110,-5
22000129,UTA,1610612762,49,97,0.505,25,53,0.471698113,0.615,24,44,0.545454545,Jazz,Utah,240,8,13,10,40,50,31,6,8,10,18,131,13
22000129,MIL,1610612749,44,98,0.449,13,42,0.30952381,0.81,31,56,0.553571429,Bucks,Milwaukee,240,17,21,9,36,45,18,5,5,12,19,118,-13
22000130,LAC,1610612746,40,83,0.482,14,31,0.451612903,0.846,26,52,0.5,Clippers,LA,240,11,13,10,27,37,23,6,5,18,16,105,-10
22000130,GSW,1610612744,40,82,0.488,20,41,0.487804878,0.833,20,41,0.487804878,Warriors,Golden State,240,15,18,9,29,38,25,13,3,15,19,115,10
22000131,LAL,1610612747,41,81,0.506,12,29,0.413793103,0.852,29,52,0.557692308,Lakers,Los Angeles,240,23,27,10,32,42,21,3,8,15,15,117,2
22000131,CHI,1610612741,46,91,0.505,10,26,0.384615385,0.929,36,65,0.553846154,Bulls,Chicago,240,13,14,9,32,41,26,10,3,12,23,115,-2
22000132,TOR,1610612761,53,91,0.582,20,39,0.512820513,0.818,33,52,0.634615385,Raptors,Toronto,240,18,22,12,32,44,30,8,5,12,20,144,21
22000132,SAC,1610612758,46,81,0.568,15,34,0.441176471,0.571,31,47,0.659574468,Kings,Sacramento,240,16,28,3,23,26,36,9,8,11,18,123,-21
22000133,PHI,1610612755,43,103,0.417,11,35,0.314285714,0.6,32,68,0.470588235,76ers,Philadelphia,240,6,10,20,28,48,23,8,4,16,19,103,-12
22000133,DEN,1610612743,45,90,0.5,12,33,0.363636364,0.867,33,57,0.578947368,Nuggets,Denver,240,13,15,15,30,45,28,11,7,17,12,115,12
22000134,CHA,1610612766,40,77,0.519,15,33,0.454545455,0.75,25,44,0.568181818,Hornets,Charlotte,240,18,24,6,35,41,27,11,7,15,19,113,8
22000134,ATL,1610612737,34,89,0.382,14,45,0.311111111,0.821,20,44,0.454545455,Hawks,Atlanta,240,23,28,17,30,47,25,10,4,14,22,105,-8
22000135,PHX,1610612756,46,94,0.489,16,41,0.390243902,1,30,53,0.566037736,Suns,Phoenix,240,17,17,4,36,40,33,6,2,2,17,125,8
22000135,IND,1610612754,44,92,0.478,12,29,0.413793103,0.708,32,63,0.507936508,Pacers,Indiana,240,17,24,13,39,52,23,2,4,10,19,117,-8
22000136,WAS,1610612764,44,99,0.444,15,40,0.375,0.75,29,59,0.491525424,Wizards,Washington,240,21,28,7,32,39,25,9,2,6,24,124,-4
22000136,MIA,1610612748,46,93,0.495,16,43,0.372093023,0.769,30,50,0.6,Heat,Miami,240,20,26,10,51,61,32,3,5,16,24,128,4
22000137,MIL,1610612749,37,84,0.44,12,36,0.333333333,0.778,25,48,0.520833333,Bucks,Milwaukee,240,14,18,11,34,45,25,11,4,15,14,100,10
22000137,CLE,1610612739,36,87,0.414,7,26,0.269230769,0.688,29,61,0.475409836,Cavaliers,Cleveland,240,11,16,14,33,47,16,6,4,15,18,90,-10
22000138,SAS,1610612759,44,101,0.436,13,32,0.40625,0.828,31,69,0.449275362,Spurs,San Antonio,265,24,29,12,36,48,22,8,3,6,19,125,3
22000138,MIN,1610612750,48,96,0.5,15,30,0.5,0.647,33,66,0.5,Timberwolves,Minnesota,265,11,17,11,42,53,29,1,7,16,20,122,-3
22000139,ORL,1610612753,38,89,0.427,6,31,0.193548387,0.727,32,58,0.551724138,Magic,Orlando,240,16,22,10,33,43,17,11,2,9,16,98,-14
22000139,DAL,1610612742,39,79,0.494,20,40,0.5,0.778,19,39,0.487179487,Mavericks,Dallas,240,14,18,6,38,44,25,5,8,17,17,112,14
22000140,SAC,1610612758,33,81,0.407,8,30,0.266666667,0.714,25,51,0.490196078,Kings,Sacramento,240,25,35,6,41,47,21,4,5,15,20,99,-26
22000140,POR,1610612757,44,100,0.44,17,41,0.414634146,0.87,27,59,0.457627119,Trail Blazers,Portland,240,20,23,9,41,50,26,10,5,8,27,125,26
22000141,UTA,1610612762,35,82,0.427,11,35,0.314285714,0.682,24,47,0.510638298,Jazz,Utah,240,15,22,16,47,63,17,3,5,13,17,96,10
22000141,DET,1610612765,29,87,0.333,10,42,0.238095238,0.857,19,45,0.422222222,Pistons,Detroit,240,18,21,11,28,39,21,10,7,7,23,86,-10
22000142,LAC,1610612746,45,92,0.489,20,38,0.526315789,0.8,25,54,0.462962963,Clippers,LA,240,20,25,12,23,35,28,13,5,10,19,130,3
22000142,CHI,1610612741,47,77,0.61,18,33,0.545454545,0.882,29,44,0.659090909,Bulls,Chicago,240,15,17,3,35,38,30,6,2,22,19,127,-3
22000143,OKC,1610612760,49,90,0.544,15,39,0.384615385,0.941,34,51,0.666666667,Thunder,Oklahoma City,240,16,17,3,31,34,24,12,4,10,22,129,13
22000143,BKN,1610612751,43,85,0.506,10,34,0.294117647,0.833,33,51,0.647058824,Nets,Brooklyn,240,20,24,6,37,43,23,3,2,17,18,116,-13
22000144,NYK,1610612752,32,74,0.432,6,21,0.285714286,0.76,26,53,0.490566038,Knicks,New York,240,19,25,8,28,36,19,4,1,16,15,89,-25
22000144,DEN,1610612743,45,84,0.536,15,35,0.428571429,0.75,30,49,0.612244898,Nuggets,Denver,240,9,12,8,35,43,23,11,4,12,25,114,25
22000145,MIA,1610612748,47,82,0.573,16,35,0.457142857,0.909,31,47,0.659574468,Heat,Miami,240,20,22,3,32,35,30,8,2,11,20,130,6
22000145,BOS,1610612738,45,83,0.542,14,38,0.368421053,0.8,31,45,0.688888889,Celtics,Boston,240,20,25,6,28,34,29,7,3,14,22,124,-6
22000146,LAL,1610612747,46,91,0.505,10,29,0.344827586,0.75,36,62,0.580645161,Lakers,Los Angeles,240,18,24,10,39,49,28,13,8,16,23,120,18
22000146,HOU,1610612745,37,90,0.411,12,41,0.292682927,0.696,25,49,0.510204082,Rockets,Houston,240,16,23,13,30,43,22,7,8,21,22,102,-18
22000147,SAS,1610612759,36,94,0.383,8,30,0.266666667,0.571,28,64,0.4375,Spurs,San Antonio,240,8,14,9,36,45,21,4,5,10,16,88,-8
22000147,MIN,1610612750,34,81,0.42,9,26,0.346153846,0.826,25,55,0.454545455,Timberwolves,Minnesota,240,19,23,9,43,52,19,6,3,13,17,96,8
22000148,TOR,1610612761,39,96,0.406,13,38,0.342105263,0.636,26,58,0.448275862,Raptors,Toronto,240,14,22,13,35,48,20,8,10,10,22,105,-1
22000148,GSW,1610612744,38,93,0.409,13,46,0.282608696,0.895,25,47,0.531914894,Warriors,Golden State,240,17,19,12,39,51,30,2,10,15,18,106,1
22000149,NYK,1610612752,34,87,0.391,9,37,0.243243243,0.647,25,50,0.5,Knicks,New York,240,11,17,17,32,49,20,6,6,16,23,88,-21
22000149,CHA,1610612766,38,78,0.487,13,32,0.40625,0.87,25,46,0.543478261,Hornets,Charlotte,240,20,23,5,32,37,28,8,8,10,13,109,21
22000150,MEM,1610612763,40,78,0.513,5,20,0.25,0.762,35,58,0.603448276,Grizzlies,Memphis,240,16,21,7,33,40,32,10,6,15,17,101,10
22000150,CLE,1610612739,37,82,0.451,11,26,0.423076923,0.429,26,56,0.464285714,Cavaliers,Cleveland,240,6,14,10,30,40,20,11,7,17,21,91,-10
22000151,ORL,1610612753,39,91,0.429,11,31,0.35483871,0.769,28,60,0.466666667,Magic,Orlando,240,10,13,15,29,44,24,5,4,18,13,99,-22
22000151,MIL,1610612749,46,91,0.505,13,35,0.371428571,0.8,33,56,0.589285714,Bucks,Milwaukee,240,16,20,11,32,43,25,15,7,14,17,121,22
22000152,WAS,1610612764,48,92,0.522,15,34,0.441176471,0.607,33,58,0.568965517,Wizards,Washington,240,17,28,14,39,53,29,3,3,7,23,128,21
22000152,PHX,1610612756,39,87,0.448,4,27,0.148148148,0.833,35,60,0.583333333,Suns,Phoenix,240,25,30,8,34,42,21,3,6,6,22,107,-21
22000153,PHI,1610612755,37,92,0.402,8,36,0.222222222,0.923,29,56,0.517857143,76ers,Philadelphia,240,12,13,9,41,50,20,2,12,9,17,94,-18
22000153,ATL,1610612737,37,99,0.374,17,44,0.386363636,0.778,20,55,0.363636364,Hawks,Atlanta,240,21,27,14,44,58,20,7,3,8,13,112,18
22000154,NOP,1610612740,36,87,0.414,7,28,0.25,0.737,29,59,0.491525424,Pelicans,New Orleans,240,28,38,11,33,44,18,5,2,12,18,107,-18
22000154,DAL,1610612742,47,96,0.49,15,45,0.333333333,0.8,32,51,0.62745098,Mavericks,Dallas,240,16,20,9,39,48,23,4,2,8,27,125,18
22000155,TOR,1610612761,40,89,0.449,19,47,0.404255319,1,21,42,0.5,Raptors,Toronto,240,12,12,7,36,43,27,6,5,15,22,111,-1
22000155,POR,1610612757,38,83,0.458,14,42,0.333333333,0.88,24,41,0.585365854,Trail Blazers,Portland,240,22,25,8,34,42,18,9,6,13,14,112,1
22000156,SAC,1610612758,47,84,0.56,15,32,0.46875,0.783,32,52,0.615384615,Kings,Sacramento,240,18,23,7,37,44,29,6,9,18,17,127,5
22000156,IND,1610612754,47,97,0.485,13,39,0.333333333,0.833,34,58,0.586206897,Pacers,Indiana,240,15,18,10,27,37,26,14,3,12,21,122,-5
22000157,PHI,1610612755,50,102,0.49,19,55,0.345454545,0.72,31,47,0.659574468,76ers,Philadelphia,265,18,25,16,36,52,32,10,6,17,21,137,3
22000157,MIA,1610612748,48,104,0.462,19,56,0.339285714,0.792,29,48,0.604166667,Heat,Miami,265,19,24,14,32,46,27,6,4,18,21,134,-3
22000158,DEN,1610612743,44,88,0.5,18,37,0.486486486,0.625,26,51,0.509803922,Nuggets,Denver,240,10,16,9,23,32,28,12,5,13,18,116,-6
22000158,BKN,1610612751,48,79,0.608,16,32,0.5,0.667,32,47,0.680851064,Nets,Brooklyn,240,10,15,8,33,41,31,6,6,18,18,122,6
22000159,UTA,1610612762,42,84,0.5,24,45,0.533333333,0.75,18,39,0.461538462,Jazz,Utah,240,9,12,10,38,48,26,8,8,16,16,117,30
22000159,CLE,1610612739,35,90,0.389,8,31,0.258064516,0.643,27,59,0.457627119,Cavaliers,Cleveland,240,9,14,12,28,40,23,7,4,12,13,87,-30
22000160,CHI,1610612741,43,99,0.434,18,40,0.45,0.944,25,59,0.423728814,Bulls,Chicago,240,17,18,15,37,52,26,10,4,9,20,121,22
22000160,BOS,1610612738,35,86,0.407,11,39,0.282051282,0.783,24,47,0.510638298,Celtics,Boston,240,18,23,11,36,47,19,5,8,13,15,99,-22
22000161,LAL,1610612747,42,84,0.5,14,32,0.4375,0.704,28,52,0.538461538,Lakers,Los Angeles,240,19,27,11,44,55,26,10,12,20,18,117,17
22000161,HOU,1610612745,38,97,0.392,12,40,0.3,0.75,26,57,0.456140351,Rockets,Houston,240,12,16,10,32,42,23,14,5,13,19,100,-17
22000162,SAS,1610612759,41,95,0.432,10,35,0.285714286,0.909,31,60,0.516666667,Spurs,San Antonio,240,20,22,7,39,46,26,8,5,4,20,112,10
22000162,OKC,1610612760,36,83,0.434,7,26,0.269230769,0.793,29,57,0.50877193,Thunder,Oklahoma City,240,23,29,7,45,52,18,1,5,13,20,102,-10
22000163,IND,1610612754,39,88,0.443,9,28,0.321428571,0.68,30,60,0.5,Pacers,Indiana,240,17,25,10,40,50,26,9,9,14,17,104,9
22000163,GSW,1610612744,34,89,0.382,13,38,0.342105263,0.636,21,51,0.411764706,Warriors,Golden State,240,14,22,10,36,46,25,8,8,15,21,95,-9
22000164,DAL,1610612742,40,96,0.417,15,46,0.326086957,0.563,25,50,0.5,Mavericks,Dallas,240,9,16,13,41,54,22,8,12,10,15,104,11
22000164,CHA,1610612766,38,100,0.38,10,38,0.263157895,0.5,28,62,0.451612903,Hornets,Charlotte,240,7,14,15,38,53,26,8,7,11,17,93,-11
22000165,MIL,1610612749,41,85,0.482,19,43,0.441860465,0.643,22,42,0.523809524,Bucks,Milwaukee,240,9,14,10,38,48,31,10,9,14,20,110,9
22000165,DET,1610612765,36,92,0.391,14,35,0.4,0.682,22,57,0.385964912,Pistons,Detroit,240,15,22,13,34,47,25,8,3,16,19,101,-9
22000166,WAS,1610612764,47,86,0.547,7,17,0.411764706,0.789,40,69,0.579710145,Wizards,Washington,240,30,38,7,36,43,23,6,2,13,27,131,9
22000166,UTA,1610612762,44,96,0.458,18,48,0.375,0.571,26,48,0.541666667,Jazz,Utah,240,16,28,11,36,47,19,10,3,16,27,122,-9
22000167,ORL,1610612753,32,84,0.381,11,34,0.323529412,0.7,21,50,0.42,Magic,Orlando,240,21,30,9,35,44,20,6,4,6,13,96,-16
22000167,BOS,1610612738,40,88,0.455,23,55,0.418181818,1,17,33,0.515151515,Celtics,Boston,240,9,9,7,38,45,27,6,3,9,21,112,16
22000168,NYK,1610612752,44,92,0.478,11,28,0.392857143,0.833,33,64,0.515625,Knicks,New York,240,10,12,12,31,43,22,4,3,9,16,109,-7
22000168,BKN,1610612751,44,91,0.484,16,40,0.4,0.706,28,51,0.549019608,Nets,Brooklyn,240,12,17,12,34,46,29,3,5,6,12,116,7
22000169,MIN,1610612750,39,90,0.433,9,37,0.243243243,0.833,30,53,0.566037736,Timberwolves,Minnesota,240,20,24,11,37,48,27,3,6,12,18,107,-11
22000169,MEM,1610612763,50,106,0.472,8,25,0.32,0.769,42,81,0.518518519,Grizzlies,Memphis,240,10,13,15,32,47,33,11,5,7,24,118,11
22000170,OKC,1610612760,37,86,0.43,10,31,0.322580645,0.789,27,55,0.490909091,Thunder,Oklahoma City,240,15,19,9,33,42,23,4,6,11,21,99,-29
22000170,LAL,1610612747,47,95,0.495,17,37,0.459459459,0.773,30,58,0.517241379,Lakers,Los Angeles,240,17,22,12,38,50,26,6,6,9,16,128,29
22000171,PHX,1610612756,45,88,0.511,12,32,0.375,0.833,33,56,0.589285714,Suns,Phoenix,240,15,18,11,38,49,27,6,1,13,14,117,7
22000171,ATL,1610612737,41,85,0.482,13,32,0.40625,0.714,28,53,0.528301887,Hawks,Atlanta,240,15,21,6,30,36,30,9,1,7,17,110,-7
22000172,NOP,1610612740,42,88,0.477,10,28,0.357142857,0.75,32,60,0.533333333,Pelicans,New Orleans,240,12,16,12,36,48,18,4,4,9,19,106,-5
22000172,LAC,1610612746,35,74,0.473,18,37,0.486486486,0.852,17,37,0.459459459,Clippers,LA,240,23,27,3,33,36,26,4,6,10,16,111,5
22000173,SAC,1610612758,44,84,0.524,19,38,0.5,0.731,25,46,0.543478261,Kings,Sacramento,240,19,26,8,34,42,35,4,2,13,18,126,-6
22000173,POR,1610612757,44,90,0.489,23,48,0.479166667,0.778,21,42,0.5,Trail Blazers,Portland,240,21,27,12,26,38,28,9,8,8,24,132,6
22000174,PHI,1610612755,44,82,0.537,17,37,0.459459459,0.833,27,45,0.6,76ers,Philadelphia,240,20,24,5,30,35,27,15,3,18,22,125,17
22000174,MIA,1610612748,40,81,0.494,12,34,0.352941176,0.615,28,47,0.595744681,Heat,Miami,240,16,26,9,32,41,28,4,1,20,19,108,-17
22000175,TOR,1610612761,40,88,0.455,20,50,0.4,0.846,20,38,0.526315789,Raptors,Toronto,240,11,13,13,27,40,33,13,6,17,16,111,3
22000175,CHA,1610612766,42,87,0.483,15,35,0.428571429,0.75,27,52,0.519230769,Hornets,Charlotte,240,9,12,14,30,44,32,11,5,18,15,108,-3
22000176,SAS,1610612759,42,92,0.457,9,31,0.290322581,0.75,33,61,0.540983607,Spurs,San Antonio,240,12,16,10,31,41,26,10,4,10,17,105,-4
22000176,HOU,1610612745,42,86,0.488,13,33,0.393939394,0.632,29,53,0.547169811,Rockets,Houston,240,12,19,10,39,49,25,6,6,18,16,109,4
22000177,GSW,1610612744,38,81,0.469,11,29,0.379310345,0.708,27,52,0.519230769,Warriors,Golden State,240,17,24,5,38,43,29,9,4,19,25,104,-10
22000177,DEN,1610612743,41,90,0.456,11,37,0.297297297,0.778,30,53,0.566037736,Nuggets,Denver,240,21,27,10,40,50,29,11,5,13,23,114,10
22000178,POR,1610612757,32,87,0.368,13,43,0.302325581,1,19,44,0.431818182,Trail Blazers,Portland,240,10,10,14,29,43,16,8,5,18,22,87,-24
22000178,IND,1610612754,44,92,0.478,9,30,0.3,0.778,35,62,0.564516129,Pacers,Indiana,240,14,18,13,37,50,29,11,5,12,13,111,24
22000179,WAS,1610612764,40,85,0.471,5,19,0.263157895,0.316,35,66,0.53030303,Wizards,Washington,240,6,19,4,36,40,25,6,6,14,21,91,-29
22000179,DET,1610612765,45,94,0.479,12,29,0.413793103,0.818,33,65,0.507692308,Pistons,Detroit,240,18,22,10,38,48,31,8,5,13,18,120,29
22000180,ORL,1610612753,38,94,0.404,7,28,0.25,0.636,31,66,0.46969697,Magic,Orlando,240,14,22,15,31,46,14,5,1,11,16,97,-27
22000180,BOS,1610612738,45,88,0.511,17,42,0.404761905,0.895,28,46,0.608695652,Celtics,Boston,240,17,19,6,39,45,25,7,4,10,18,124,27
22000181,NYK,1610612752,40,82,0.488,9,25,0.36,0.875,31,57,0.543859649,Knicks,New York,240,14,16,7,32,39,20,9,10,12,21,103,-3
22000181,CLE,1610612739,36,79,0.456,9,27,0.333333333,0.735,27,52,0.519230769,Cavaliers,Cleveland,240,25,34,14,34,48,26,9,6,15,18,106,3
22000182,MIL,1610612749,43,96,0.448,14,37,0.378378378,0.48,29,59,0.491525424,Bucks,Milwaukee,240,12,25,16,41,57,22,5,3,10,14,112,3
22000182,DAL,1610612742,45,97,0.464,13,36,0.361111111,0.462,32,61,0.524590164,Mavericks,Dallas,240,6,13,11,40,51,22,5,6,9,23,109,-3
22000183,MIN,1610612750,49,94,0.521,19,39,0.487179487,0.818,30,55,0.545454545,Timberwolves,Minnesota,240,18,22,12,29,41,32,7,5,14,22,135,-4
22000183,MEM,1610612763,52,97,0.536,14,29,0.482758621,0.75,38,68,0.558823529,Grizzlies,Memphis,240,21,28,12,34,46,30,6,4,13,19,139,4
22000184,OKC,1610612760,48,105,0.457,15,45,0.333333333,0.667,33,60,0.55,Thunder,Oklahoma City,265,16,24,7,37,44,26,12,2,11,23,127,2
22000184,CHI,1610612741,43,91,0.473,21,46,0.456521739,0.72,22,45,0.488888889,Bulls,Chicago,265,18,25,9,47,56,27,5,8,24,25,125,-2
22000185,PHX,1610612756,49,96,0.51,12,30,0.4,0.769,37,66,0.560606061,Suns,Phoenix,240,10,13,12,40,52,31,8,4,16,16,120,22
22000185,GSW,1610612744,38,88,0.432,12,35,0.342857143,0.625,26,53,0.490566038,Warriors,Golden State,240,10,16,9,31,40,22,9,4,17,11,98,-22
22000186,UTA,1610612762,43,92,0.467,20,44,0.454545455,0.714,23,48,0.479166667,Jazz,Utah,240,10,14,12,41,53,27,7,6,19,18,116,24
22000186,ATL,1610612737,38,92,0.413,5,28,0.178571429,0.733,33,64,0.515625,Hawks,Atlanta,240,11,15,8,33,41,21,6,1,15,16,92,-24
22000187,NOP,1610612740,41,86,0.477,9,29,0.310344828,0.5,32,57,0.561403509,Pelicans,New Orleans,240,4,8,10,37,47,22,3,5,20,21,95,-17
22000187,LAL,1610612747,39,93,0.419,15,37,0.405405405,0.731,24,56,0.428571429,Lakers,Los Angeles,240,19,26,13,31,44,31,11,6,6,16,112,17
22000188,SAC,1610612758,40,85,0.471,8,26,0.307692308,0.706,32,59,0.542372881,Kings,Sacramento,240,12,17,9,23,32,23,4,2,14,16,100,-38
22000188,LAC,1610612746,52,89,0.584,18,35,0.514285714,0.8,34,54,0.62962963,Clippers,LA,240,16,20,12,35,47,29,10,3,9,19,138,38
22000189,SAS,1610612759,40,100,0.4,5,24,0.208333333,0.783,35,76,0.460526316,Spurs,San Antonio,240,18,23,17,41,58,19,10,7,12,21,103,12
22000189,HOU,1610612745,31,84,0.369,12,32,0.375,0.63,19,52,0.365384615,Rockets,Houston,240,17,27,12,39,51,20,6,9,22,20,91,-12
22000190,ORL,1610612753,44,95,0.463,14,46,0.304347826,0.813,30,49,0.612244898,Magic,Orlando,240,13,16,9,29,38,28,13,4,12,19,115,-7
22000190,BKN,1610612751,42,78,0.538,16,35,0.457142857,0.88,26,43,0.604651163,Nets,Brooklyn,240,22,25,4,37,41,24,9,5,19,14,122,7
22000191,TOR,1610612761,36,86,0.419,21,49,0.428571429,0.885,15,37,0.405405405,Raptors,Toronto,240,23,26,7,36,43,28,5,8,15,22,116,3
22000191,CHA,1610612766,38,87,0.437,15,36,0.416666667,0.759,23,51,0.450980392,Hornets,Charlotte,240,22,29,12,36,48,26,6,5,14,20,113,-3
22000192,MIA,1610612748,32,67,0.478,12,29,0.413793103,0.889,20,38,0.526315789,Heat,Miami,240,24,27,5,26,31,25,1,5,22,21,100,-20
22000192,DET,1610612765,46,91,0.505,18,46,0.391304348,0.667,28,45,0.622222222,Pistons,Detroit,240,10,15,10,29,39,34,9,8,11,28,120,20
22000193,PHI,1610612755,37,84,0.44,7,25,0.28,0.719,30,59,0.508474576,76ers,Philadelphia,240,23,32,15,38,53,23,5,11,22,17,104,-2
22000193,MEM,1610612763,43,99,0.434,8,29,0.275862069,0.667,35,70,0.5,Grizzlies,Memphis,240,12,18,11,32,43,27,15,3,11,25,106,2
22000194,PHX,1610612756,43,91,0.473,12,31,0.387096774,0.765,31,60,0.516666667,Suns,Phoenix,240,13,17,10,30,40,28,9,4,16,17,111,-11
22000194,IND,1610612754,46,87,0.529,13,28,0.464285714,0.81,33,59,0.559322034,Pacers,Indiana,240,17,21,9,36,45,25,9,6,15,18,122,11
22000195,POR,1610612757,40,103,0.388,15,44,0.340909091,0.85,25,59,0.423728814,Trail Blazers,Portland,240,17,20,17,38,55,18,6,8,7,20,112,6
22000195,ATL,1610612737,38,87,0.437,6,30,0.2,0.857,32,57,0.561403509,Hawks,Atlanta,240,24,28,7,41,48,24,4,6,13,22,106,-6
22000196,NYK,1610612752,38,80,0.475,12,31,0.387096774,0.81,26,49,0.530612245,Knicks,New York,240,17,21,10,43,53,22,11,7,16,28,105,30
22000196,BOS,1610612738,25,84,0.298,7,46,0.152173913,0.621,18,38,0.473684211,Celtics,Boston,240,18,29,14,29,43,15,10,2,17,22,75,-30
22000197,WAS,1610612764,43,89,0.483,12,31,0.387096774,0.808,31,58,0.534482759,Wizards,Washington,240,21,26,10,26,36,25,11,6,10,21,119,9
22000197,CLE,1610612739,40,78,0.513,10,27,0.37037037,0.8,30,51,0.588235294,Cavaliers,Cleveland,240,20,25,10,27,37,28,5,4,19,25,110,-9
22000198,DAL,1610612742,41,93,0.441,8,31,0.258064516,0.579,33,62,0.532258065,Mavericks,Dallas,240,11,19,12,35,47,18,6,2,16,23,101,-16
22000198,CHI,1610612741,43,85,0.506,7,25,0.28,0.727,36,60,0.6,Bulls,Chicago,240,24,33,5,42,47,32,14,6,13,23,117,16
22000199,PHI,1610612755,44,94,0.468,12,38,0.315789474,0.68,32,56,0.571428571,76ers,Philadelphia,240,17,25,13,34,47,24,11,10,9,17,117,24
22000199,OKC,1610612760,38,76,0.5,8,20,0.4,0.474,30,56,0.535714286,Thunder,Oklahoma City,240,9,19,6,39,45,21,3,4,22,21,93,-24
22000200,UTA,1610612762,39,76,0.513,15,37,0.405405405,0.571,24,39,0.615384615,Jazz,Utah,240,16,28,7,29,36,24,7,6,13,21,109,4
22000200,DEN,1610612743,40,100,0.4,14,37,0.378378378,0.733,26,63,0.412698413,Nuggets,Denver,240,11,15,23,29,52,25,6,6,9,23,105,-4
22000201,SAC,1610612758,47,91,0.516,13,39,0.333333333,0.889,34,52,0.653846154,Kings,Sacramento,240,16,18,8,25,33,23,7,7,10,24,123,-5
22000201,NOP,1610612740,45,85,0.529,11,22,0.5,0.794,34,63,0.53968254,Pelicans,New Orleans,240,27,34,14,34,48,24,5,1,13,15,128,5
22000202,LAC,1610612746,48,87,0.552,19,39,0.487179487,0.7,29,48,0.604166667,Clippers,LA,240,14,20,9,43,52,27,4,3,16,19,129,33
22000202,IND,1610612754,37,89,0.416,11,38,0.289473684,0.688,26,51,0.509803922,Pacers,Indiana,240,11,16,6,27,33,28,13,2,16,19,96,-33
22000203,ORL,1610612753,29,86,0.337,12,38,0.315789474,0.875,17,48,0.354166667,Magic,Orlando,240,14,16,10,41,51,18,4,9,11,24,84,-7
22000203,NYK,1610612752,31,87,0.356,5,27,0.185185185,0.706,26,60,0.433333333,Knicks,New York,240,24,34,13,40,53,15,6,4,6,16,91,7
22000204,WAS,1610612764,41,89,0.461,7,25,0.28,0.838,34,64,0.53125,Wizards,Washington,240,31,37,12,35,47,23,9,6,10,19,120,15
22000204,CLE,1610612739,39,84,0.464,10,36,0.277777778,0.81,29,48,0.604166667,Cavaliers,Cleveland,240,17,21,7,37,44,24,4,3,17,21,105,-15
22000205,MIN,1610612750,36,91,0.396,14,37,0.378378378,0.688,22,54,0.407407407,Timberwolves,Minnesota,240,11,16,9,30,39,22,16,6,18,21,97,-11
22000205,ATL,1610612737,37,79,0.468,11,28,0.392857143,0.92,26,51,0.509803922,Hawks,Atlanta,240,23,25,7,41,48,32,15,8,24,17,108,11
22000206,MIA,1610612748,43,75,0.573,12,30,0.4,0.789,31,45,0.688888889,Heat,Miami,240,15,19,5,31,36,23,8,6,18,27,113,6
22000206,DET,1610612765,38,82,0.463,13,37,0.351351351,0.75,25,45,0.555555556,Pistons,Detroit,240,18,24,10,22,32,24,8,3,16,23,107,-6
22000207,SAS,1610612759,48,90,0.533,15,33,0.454545455,0.875,33,57,0.578947368,Spurs,San Antonio,240,14,16,12,36,48,33,6,6,12,17,125,21
22000207,POR,1610612757,39,90,0.433,10,35,0.285714286,0.842,29,55,0.527272727,Trail Blazers,Portland,240,16,19,8,26,34,20,9,6,13,15,104,-21
22000208,PHX,1610612756,40,88,0.455,15,36,0.416666667,0.563,25,52,0.480769231,Suns,Phoenix,240,9,16,12,32,44,30,8,4,18,20,104,-4
22000208,MEM,1610612763,41,83,0.494,11,26,0.423076923,0.75,30,57,0.526315789,Grizzlies,Memphis,240,15,20,9,31,40,31,13,3,15,15,108,4
22000209,MIL,1610612749,46,105,0.438,11,38,0.289473684,0.833,35,67,0.52238806,Bucks,Milwaukee,240,20,24,11,30,41,21,9,2,5,15,123,-2
22000209,BKN,1610612751,46,84,0.548,15,31,0.483870968,0.857,31,53,0.58490566,Nets,Brooklyn,240,18,21,7,42,49,26,2,5,17,19,125,2
22000210,TOR,1610612761,44,88,0.5,12,33,0.363636364,0.889,32,55,0.581818182,Raptors,Toronto,240,16,18,9,37,46,23,9,6,14,23,116,23
22000210,DAL,1610612742,31,82,0.378,9,36,0.25,0.815,22,46,0.47826087,Mavericks,Dallas,240,22,27,8,30,38,21,6,4,16,16,93,-23
22000211,HOU,1610612745,46,88,0.523,17,40,0.425,0.647,29,48,0.604166667,Rockets,Houston,240,11,17,2,34,36,25,8,1,17,20,120,-5
22000211,CHI,1610612741,43,92,0.467,20,45,0.444444444,0.905,23,47,0.489361702,Bulls,Chicago,240,19,21,10,37,47,23,10,3,17,19,125,5
22000212,LAL,1610612747,40,83,0.482,9,29,0.310344828,0.727,31,54,0.574074074,Lakers,Los Angeles,240,24,33,12,38,50,23,6,5,16,22,113,-2
22000212,GSW,1610612744,44,87,0.506,12,37,0.324324324,0.75,32,50,0.64,Warriors,Golden State,240,15,20,5,27,32,31,8,3,13,27,115,2
22000213,OKC,1610612760,36,86,0.419,14,43,0.325581395,0.652,22,43,0.511627907,Thunder,Oklahoma City,240,15,23,9,32,41,22,8,4,19,15,101,-18
22000213,DEN,1610612743,46,105,0.438,14,42,0.333333333,0.929,32,63,0.507936508,Nuggets,Denver,240,13,14,18,40,58,29,11,3,14,22,119,18
22000214,UTA,1610612762,43,85,0.506,21,47,0.446808511,0.647,22,38,0.578947368,Jazz,Utah,240,11,17,11,43,54,28,4,7,14,17,118,16
22000214,NOP,1610612740,43,95,0.453,6,26,0.230769231,0.667,37,69,0.536231884,Pelicans,New Orleans,240,10,15,10,28,38,17,8,3,8,15,102,-16
22000215,WAS,1610612764,34,90,0.378,9,40,0.225,0.714,25,50,0.5,Wizards,Washington,240,20,28,12,36,48,22,6,5,14,18,97,-22
22000215,CHA,1610612766,42,99,0.424,15,36,0.416666667,0.769,27,63,0.428571429,Hornets,Charlotte,240,20,26,18,41,59,21,6,6,11,25,119,22
22000216,CLE,1610612739,56,109,0.514,20,40,0.5,0.714,36,69,0.52173913,Cavaliers,Cleveland,290,15,21,12,38,50,29,10,6,14,21,147,12
22000216,BKN,1610612751,48,106,0.453,15,41,0.365853659,0.889,33,65,0.507692308,Nets,Brooklyn,290,24,27,13,39,52,30,8,11,16,24,135,-12
22000217,IND,1610612754,41,92,0.446,16,39,0.41025641,0.667,25,53,0.471698113,Pacers,Indiana,240,14,21,8,30,38,21,6,3,10,20,112,-12
22000217,DAL,1610612742,51,97,0.526,8,27,0.296296296,0.824,43,70,0.614285714,Mavericks,Dallas,240,14,17,9,40,49,32,5,6,8,17,124,12
22000218,PHI,1610612755,36,78,0.462,9,27,0.333333333,0.8,27,51,0.529411765,76ers,Philadelphia,240,36,45,11,30,41,20,12,3,9,20,117,8
22000218,BOS,1610612738,42,89,0.472,12,33,0.363636364,0.65,30,56,0.535714286,Celtics,Boston,240,13,20,10,35,45,22,3,0,16,29,109,-8
22000219,DET,1610612765,44,97,0.454,10,31,0.322580645,0.895,34,66,0.515151515,Pistons,Detroit,265,17,19,7,35,42,22,9,3,13,28,115,-8
22000219,ATL,1610612737,44,100,0.44,9,23,0.391304348,0.684,35,77,0.454545455,Hawks,Atlanta,265,26,38,23,40,63,21,6,10,13,15,123,8
22000220,TOR,1610612761,35,88,0.398,16,49,0.326530612,0.889,19,39,0.487179487,Raptors,Toronto,240,16,18,12,29,41,27,8,3,12,21,102,-9
22000220,MIA,1610612748,39,80,0.487,18,40,0.45,0.882,21,40,0.525,Heat,Miami,240,15,17,8,38,46,29,4,5,18,19,111,9
22000221,ORL,1610612753,36,92,0.391,10,31,0.322580645,0.714,26,61,0.426229508,Magic,Orlando,240,15,21,13,35,48,26,5,8,11,17,97,1
22000221,MIN,1610612750,36,85,0.424,15,35,0.428571429,0.643,21,50,0.42,Timberwolves,Minnesota,240,9,14,8,35,43,25,5,12,13,20,96,-1
22000222,PHX,1610612756,42,89,0.472,8,34,0.235294118,0.895,34,55,0.618181818,Suns,Phoenix,240,17,19,8,37,45,25,6,11,17,21,109,6
22000222,HOU,1610612745,37,88,0.42,10,31,0.322580645,0.864,27,57,0.473684211,Rockets,Houston,240,19,22,7,32,39,17,11,5,16,19,103,-6
22000223,SAS,1610612759,35,94,0.372,4,33,0.121212121,0.806,31,61,0.508196721,Spurs,San Antonio,240,25,31,12,31,43,17,7,2,10,15,99,-22
22000223,GSW,1610612744,46,91,0.505,15,38,0.394736842,0.7,31,53,0.58490566,Warriors,Golden State,240,14,20,10,44,54,31,6,2,14,22,121,22
22000224,SAC,1610612758,39,86,0.453,13,28,0.464285714,0.417,26,58,0.448275862,Kings,Sacramento,240,5,12,4,35,39,25,11,4,18,15,96,-19
22000224,LAC,1610612746,41,86,0.477,16,35,0.457142857,0.944,25,51,0.490196078,Clippers,LA,240,17,18,6,42,48,24,14,6,16,15,115,19
22000225,POR,1610612757,46,96,0.479,14,35,0.4,0.815,32,61,0.524590164,Trail Blazers,Portland,240,22,27,14,36,50,28,6,3,11,20,128,-2
22000225,MEM,1610612763,52,98,0.531,9,30,0.3,0.773,43,68,0.632352941,Grizzlies,Memphis,240,17,22,8,31,39,33,7,5,8,21,130,2
22000226,MIL,1610612749,44,87,0.506,9,28,0.321428571,0.75,35,59,0.593220339,Bucks,Milwaukee,240,9,12,5,41,46,27,5,5,14,18,106,-7
22000226,LAL,1610612747,41,88,0.466,19,37,0.513513514,0.8,22,51,0.431372549,Lakers,Los Angeles,240,12,15,6,32,38,25,8,8,10,14,113,7
22000227,UTA,1610612762,44,88,0.5,17,39,0.435897436,0.96,27,49,0.551020408,Jazz,Utah,240,24,25,8,31,39,27,8,8,15,27,129,11
22000227,NOP,1610612740,42,85,0.494,11,25,0.44,0.767,31,60,0.516666667,Pelicans,New Orleans,240,23,30,10,31,41,27,9,2,17,19,118,-11
22000228,NYK,1610612752,38,82,0.463,11,24,0.458333333,0.78,27,58,0.465517241,Knicks,New York,240,32,41,11,44,55,24,5,9,11,29,119,15
22000228,GSW,1610612744,33,86,0.384,9,38,0.236842105,0.744,24,48,0.5,Warriors,Golden State,240,29,39,9,37,46,27,5,3,10,26,104,-15
22000229,CHI,1610612741,49,96,0.51,15,43,0.348837209,0.833,34,53,0.641509434,Bulls,Chicago,240,10,12,15,28,43,33,11,4,14,21,123,13
22000229,CHA,1610612766,42,85,0.494,7,32,0.21875,0.76,35,53,0.660377358,Hornets,Charlotte,240,19,25,12,34,46,22,8,1,21,12,110,-13
22000230,HOU,1610612745,37,95,0.389,14,41,0.341463415,0.75,23,54,0.425925926,Rockets,Houston,240,15,20,14,37,51,24,7,11,14,28,103,1
22000230,DET,1610612765,31,82,0.378,15,32,0.46875,0.676,16,50,0.32,Pistons,Detroit,240,25,37,14,41,55,17,5,8,19,21,102,-1
22000231,ORL,1610612753,43,94,0.457,17,37,0.459459459,0.625,26,57,0.456140351,Magic,Orlando,265,15,24,13,36,49,29,7,3,14,14,118,-2
22000231,IND,1610612754,46,93,0.495,12,34,0.352941176,0.889,34,59,0.576271186,Pacers,Indiana,265,16,18,8,36,44,28,9,5,10,19,120,2
22000232,CLE,1610612739,45,87,0.517,8,25,0.32,0.844,37,62,0.596774194,Cavaliers,Cleveland,240,27,32,13,37,50,24,7,3,12,18,125,12
22000232,BKN,1610612751,42,87,0.483,14,43,0.325581395,0.882,28,44,0.636363636,Nets,Brooklyn,240,15,17,6,23,29,23,5,8,11,25,113,-12
22000233,PHI,1610612755,45,81,0.556,12,28,0.428571429,0.833,33,53,0.622641509,76ers,Philadelphia,240,20,24,10,35,45,23,9,7,19,23,122,12
22000233,BOS,1610612738,41,90,0.456,12,30,0.4,0.8,29,60,0.483333333,Celtics,Boston,240,16,20,10,22,32,23,10,5,11,21,110,-12
22000234,TOR,1610612761,39,84,0.464,17,40,0.425,0.667,22,44,0.5,Raptors,Toronto,240,6,9,12,33,45,22,11,3,21,16,101,20
22000234,MIA,1610612748,33,77,0.429,7,31,0.225806452,0.8,26,46,0.565217391,Heat,Miami,240,8,10,4,28,32,19,13,4,19,14,81,-20
22000235,WAS,1610612764,47,96,0.49,8,22,0.363636364,0.744,39,74,0.527027027,Wizards,Washington,240,32,43,11,32,43,27,6,6,7,23,134,-1
22000235,MIL,1610612749,48,89,0.539,18,37,0.486486486,0.75,30,52,0.576923077,Bucks,Milwaukee,240,21,28,10,35,45,30,4,6,19,31,135,1
22000236,MIN,1610612750,40,93,0.43,8,32,0.25,0.833,32,61,0.524590164,Timberwolves,Minnesota,240,10,12,10,30,40,30,14,8,13,21,98,-18
22000236,ATL,1610612737,38,83,0.458,15,35,0.428571429,0.833,23,48,0.479166667,Hawks,Atlanta,240,25,30,13,42,55,21,9,12,16,16,116,18
22000237,SAS,1610612759,41,89,0.461,12,28,0.428571429,0.767,29,61,0.475409836,Spurs,San Antonio,240,23,30,9,40,49,21,3,5,7,18,117,-5
22000237,DAL,1610612742,45,93,0.484,14,39,0.358974359,0.9,31,54,0.574074074,Mavericks,Dallas,240,18,20,7,35,42,23,3,2,5,21,122,5
22000238,PHX,1610612756,47,94,0.5,17,44,0.386363636,1,30,50,0.6,Suns,Phoenix,265,15,15,9,36,45,30,7,4,16,23,126,-4
22000238,DEN,1610612743,53,103,0.515,6,26,0.230769231,0.947,47,77,0.61038961,Nuggets,Denver,265,18,19,10,33,43,32,12,1,9,15,130,4
22000239,OKC,1610612760,41,87,0.471,14,42,0.333333333,0.769,27,45,0.6,Thunder,Oklahoma City,240,10,13,4,25,29,24,8,1,11,21,106,-14
22000239,LAC,1610612746,43,84,0.512,10,33,0.303030303,0.96,33,51,0.647058824,Clippers,LA,240,24,25,9,39,48,21,8,7,13,19,120,14
22000240,POR,1610612757,39,105,0.371,14,38,0.368421053,0.84,25,67,0.373134328,Trail Blazers,Portland,240,21,25,15,38,53,21,11,6,11,22,113,-7
22000240,MEM,1610612763,42,91,0.462,12,23,0.52173913,0.857,30,68,0.441176471,Grizzlies,Memphis,240,24,28,8,46,54,22,9,7,15,22,120,7
22000241,SAC,1610612758,38,91,0.418,12,34,0.352941176,0.714,26,57,0.456140351,Kings,Sacramento,240,15,21,12,43,55,21,6,14,6,25,103,9
22000241,NYK,1610612752,36,94,0.383,5,22,0.227272727,0.68,31,72,0.430555556,Knicks,New York,240,17,25,16,41,57,19,2,6,11,21,94,-9
22000242,UTA,1610612762,45,94,0.479,20,50,0.4,0.773,25,44,0.568181818,Jazz,Utah,240,17,22,14,43,57,28,6,4,16,20,127,19
22000242,GSW,1610612744,42,93,0.452,14,39,0.358974359,0.667,28,54,0.518518519,Warriors,Golden State,240,10,15,4,31,35,30,6,8,11,21,108,-19
22000243,PHI,1610612755,38,83,0.458,8,23,0.347826087,0.789,30,60,0.5,76ers,Philadelphia,240,30,38,12,37,49,14,10,7,15,24,114,4
22000243,DET,1610612765,37,86,0.43,14,33,0.424242424,0.733,23,53,0.433962264,Pistons,Detroit,240,22,30,8,35,43,25,9,8,15,28,110,-4
22000244,MIA,1610612748,42,89,0.472,13,46,0.282608696,0.844,29,43,0.674418605,Heat,Miami,240,27,32,2,29,31,29,7,1,8,23,124,-4
22000244,BKN,1610612751,44,83,0.53,19,37,0.513513514,0.808,25,46,0.543478261,Nets,Brooklyn,240,21,26,9,38,47,34,0,6,16,26,128,4
22000245,LAL,1610612747,36,79,0.456,4,19,0.210526316,0.806,32,60,0.533333333,Lakers,Los Angeles,240,25,31,5,37,42,20,7,4,18,18,101,11
22000245,CHI,1610612741,33,84,0.393,8,25,0.32,0.727,25,59,0.423728814,Bulls,Chicago,240,16,22,10,35,45,18,8,1,18,28,90,-11
22000246,NOP,1610612740,40,87,0.46,10,33,0.303030303,0.714,30,54,0.555555556,Pelicans,New Orleans,240,20,28,10,32,42,21,5,4,20,24,110,-10
22000246,MIN,1610612750,39,91,0.429,12,34,0.352941176,0.811,27,57,0.473684211,Timberwolves,Minnesota,240,30,37,14,36,50,23,14,4,11,22,120,10
22000247,HOU,1610612745,47,86,0.547,16,37,0.432432432,0.793,31,49,0.632653061,Rockets,Houston,240,23,29,13,39,52,28,5,5,14,28,133,25
22000247,DAL,1610612742,37,83,0.446,5,25,0.2,0.725,32,58,0.551724138,Mavericks,Dallas,240,29,40,10,26,36,15,7,4,10,23,108,-25
22000248,PHX,1610612756,41,102,0.402,16,53,0.301886792,0.778,25,49,0.510204082,Suns,Phoenix,290,14,18,7,43,50,26,8,4,9,31,112,-8
22000248,DEN,1610612743,40,97,0.412,15,36,0.416666667,0.781,25,61,0.409836066,Nuggets,Denver,290,25,32,12,53,65,22,4,3,16,20,120,8
22000249,TOR,1610612761,37,90,0.411,15,35,0.428571429,0.692,22,55,0.4,Raptors,Toronto,240,18,26,12,33,45,24,12,8,16,18,107,5
22000249,IND,1610612754,35,87,0.402,13,39,0.333333333,0.864,22,48,0.458333333,Pacers,Indiana,240,19,22,12,35,47,23,10,8,18,23,102,-5
22000250,CLE,1610612739,34,85,0.4,10,33,0.303030303,0.735,24,52,0.461538462,Cavaliers,Cleveland,240,25,34,11,23,34,24,10,8,17,23,103,-38
22000250,BOS,1610612738,52,93,0.559,14,28,0.5,0.852,38,65,0.584615385,Celtics,Boston,240,23,27,13,42,55,26,14,8,15,23,141,38
22000251,OKC,1610612760,42,95,0.442,7,35,0.2,0.643,35,60,0.583333333,Thunder,Oklahoma City,240,9,14,12,39,51,22,7,2,10,19,100,-8
22000251,LAC,1610612746,41,92,0.446,14,46,0.304347826,0.75,27,46,0.586956522,Clippers,LA,240,12,16,8,38,46,26,4,2,10,10,108,8
22000252,ORL,1610612753,39,87,0.448,17,38,0.447368421,0.692,22,49,0.448979592,Magic,Orlando,240,9,13,11,32,43,27,4,4,15,18,104,-3
22000252,CHA,1610612766,42,88,0.477,14,36,0.388888889,0.563,28,52,0.538461538,Hornets,Charlotte,240,9,16,9,34,43,28,10,5,12,17,107,3
22000253,WAS,1610612764,39,92,0.424,14,42,0.333333333,0.643,25,50,0.5,Wizards,Washington,240,9,14,12,38,50,23,5,5,14,14,101,-20
22000253,SAS,1610612759,48,96,0.5,15,31,0.483870968,0.909,33,65,0.507692308,Spurs,San Antonio,240,10,11,5,39,44,27,11,5,8,14,121,20
22000254,MIL,1610612749,50,91,0.549,10,31,0.322580645,0.704,40,60,0.666666667,Bucks,Milwaukee,240,19,27,16,36,52,32,4,2,16,16,129,14
22000254,ATL,1610612737,42,83,0.506,14,39,0.358974359,0.773,28,44,0.636363636,Hawks,Atlanta,240,17,22,5,22,27,27,8,4,9,23,115,-14
22000255,SAC,1610612758,42,96,0.438,17,41,0.414634146,0.643,25,55,0.454545455,Kings,Sacramento,240,9,14,13,22,35,33,9,9,10,16,110,-6
22000255,MEM,1610612763,45,90,0.5,11,33,0.333333333,0.833,34,57,0.596491228,Grizzlies,Memphis,240,15,18,12,36,48,30,2,9,18,13,116,6
22000256,POR,1610612757,39,83,0.47,17,46,0.369565217,0.913,22,37,0.594594595,Trail Blazers,Portland,240,21,23,9,30,39,19,5,8,11,16,116,3
22000256,NYK,1610612752,39,86,0.453,12,29,0.413793103,0.92,27,57,0.473684211,Knicks,New York,240,23,25,13,34,47,20,9,0,12,20,113,-3
22000257,PHI,1610612755,40,94,0.426,9,28,0.321428571,0.75,31,66,0.46969697,76ers,Philadelphia,240,15,20,13,23,36,15,12,3,9,26,104,-15
22000257,DET,1610612765,35,70,0.5,17,38,0.447368421,0.842,18,32,0.5625,Pistons,Detroit,240,32,38,11,36,47,22,6,6,18,20,119,15
22000258,TOR,1610612761,38,93,0.409,14,38,0.368421053,0.889,24,55,0.436363636,Raptors,Toronto,240,24,27,13,26,39,24,9,6,10,25,114,-15
22000258,IND,1610612754,40,78,0.513,12,29,0.413793103,0.822,28,49,0.571428571,Pacers,Indiana,240,37,45,7,38,45,26,5,8,13,25,129,15
22000259,ORL,1610612753,42,88,0.477,19,37,0.513513514,0.636,23,51,0.450980392,Magic,Orlando,240,14,22,10,39,49,31,10,3,15,21,117,9
22000259,CHA,1610612766,39,89,0.438,11,38,0.289473684,0.704,28,51,0.549019608,Hornets,Charlotte,240,19,27,11,30,41,22,5,6,14,20,108,-9
22000260,MIA,1610612748,31,84,0.369,11,43,0.255813953,0.706,20,41,0.487804878,Heat,Miami,240,12,17,8,37,45,20,3,7,12,21,85,-13
22000260,BKN,1610612751,34,85,0.4,11,38,0.289473684,0.864,23,47,0.489361702,Nets,Brooklyn,240,19,22,6,43,49,24,6,5,7,18,98,13
22000261,LAL,1610612747,42,87,0.483,10,32,0.3125,0.75,32,55,0.581818182,Lakers,Los Angeles,240,21,28,15,25,40,21,7,7,13,23,115,7
22000261,CLE,1610612739,40,86,0.465,9,21,0.428571429,0.864,31,65,0.476923077,Cavaliers,Cleveland,240,19,22,15,29,44,19,8,3,17,25,108,-7
22000262,CHI,1610612741,41,88,0.466,17,39,0.435897436,0.4,24,49,0.489795918,Bulls,Chicago,240,4,10,9,32,41,28,4,7,18,16,103,-16
22000262,BOS,1610612738,44,87,0.506,15,29,0.517241379,0.8,29,58,0.5,Celtics,Boston,240,16,20,6,38,44,28,9,6,12,18,119,16
22000263,SAC,1610612758,37,96,0.385,10,42,0.238095238,0.815,27,54,0.5,Kings,Sacramento,240,22,27,14,42,56,21,7,2,10,21,106,-1
22000263,MEM,1610612763,37,84,0.44,11,33,0.333333333,0.629,26,51,0.509803922,Grizzlies,Memphis,240,22,35,9,40,49,23,8,5,13,20,107,1
22000264,SAS,1610612759,37,85,0.435,9,31,0.290322581,0.844,28,54,0.518518519,Spurs,San Antonio,240,27,32,9,37,46,22,9,8,17,23,110,2
22000264,NOP,1610612740,41,87,0.471,9,22,0.409090909,0.531,32,65,0.492307692,Pelicans,New Orleans,240,17,32,10,38,48,20,12,1,19,24,108,-2
22000265,DEN,1610612743,40,79,0.506,15,35,0.428571429,0.786,25,44,0.568181818,Nuggets,Denver,240,22,28,14,35,49,25,9,4,16,20,117,4
22000265,DAL,1610612742,41,84,0.488,11,32,0.34375,0.833,30,52,0.576923077,Mavericks,Dallas,240,20,24,8,26,34,26,11,4,11,22,113,-4
22000266,MIN,1610612750,39,94,0.415,8,24,0.333333333,0.88,31,70,0.442857143,Timberwolves,Minnesota,240,22,25,16,31,47,26,8,5,18,28,108,-22
22000266,GSW,1610612744,44,89,0.494,14,30,0.466666667,0.757,30,59,0.508474576,Warriors,Golden State,240,28,37,15,31,46,21,13,10,15,19,130,22
22000267,POR,1610612757,46,98,0.469,14,41,0.341463415,0.762,32,57,0.561403509,Trail Blazers,Portland,240,16,21,15,35,50,17,6,3,8,23,122,-3
22000267,OKC,1610612760,43,84,0.512,18,40,0.45,0.6,25,44,0.568181818,Thunder,Oklahoma City,240,21,35,9,34,43,25,5,6,8,19,125,3
22000268,LAC,1610612746,36,89,0.404,8,26,0.307692308,0.864,28,63,0.444444444,Clippers,LA,240,19,22,13,33,46,23,11,4,12,19,99,-9
22000268,ATL,1610612737,37,80,0.463,10,26,0.384615385,0.96,27,54,0.5,Hawks,Atlanta,240,24,25,9,37,46,20,7,9,14,17,108,9
22000269,WAS,1610612764,33,85,0.388,5,26,0.192307692,0.739,28,59,0.474576271,Wizards,Washington,240,17,23,12,38,50,19,7,3,20,22,88,-19
22000269,HOU,1610612745,37,88,0.42,12,37,0.324324324,0.724,25,51,0.490196078,Rockets,Houston,240,21,29,8,36,44,16,13,4,13,17,107,19
22000270,UTA,1610612762,37,92,0.402,15,48,0.3125,0.864,22,44,0.5,Jazz,Utah,240,19,22,17,36,53,24,6,5,6,14,108,14
22000270,NYK,1610612752,36,83,0.434,10,27,0.37037037,0.706,26,56,0.464285714,Knicks,New York,240,12,17,9,35,44,15,6,4,11,21,94,-14
22000271,IND,1610612754,45,88,0.511,16,40,0.4,0.833,29,48,0.604166667,Pacers,Indiana,240,10,12,11,36,47,34,1,9,12,19,116,10
22000271,CHA,1610612766,37,90,0.411,13,38,0.342105263,0.905,24,52,0.461538462,Hornets,Charlotte,240,19,21,11,28,39,28,3,3,11,14,106,-10
22000272,DET,1610612765,37,82,0.451,11,27,0.407407407,0.759,26,55,0.472727273,Pistons,Detroit,240,22,29,13,27,40,29,7,5,22,21,107,-15
22000272,CLE,1610612739,47,87,0.54,11,21,0.523809524,0.739,36,66,0.545454545,Cavaliers,Cleveland,240,17,23,8,29,37,24,14,7,16,22,122,15
22000273,SAC,1610612758,45,92,0.489,14,33,0.424242424,0.654,31,59,0.525423729,Kings,Sacramento,240,17,26,17,33,50,30,8,3,15,18,121,14
22000273,ORL,1610612753,40,96,0.417,10,26,0.384615385,0.944,30,70,0.428571429,Magic,Orlando,240,17,18,17,30,47,25,8,8,14,23,107,-14
22000274,BKN,1610612751,52,98,0.531,11,32,0.34375,0.85,41,66,0.621212121,Nets,Brooklyn,265,17,20,11,25,36,29,7,10,9,25,132,4
22000274,ATL,1610612737,45,94,0.479,13,33,0.393939394,0.893,32,61,0.524590164,Hawks,Atlanta,265,25,28,12,25,37,29,3,7,9,18,128,-4
22000275,MIA,1610612748,30,80,0.375,13,45,0.288888889,0.818,17,35,0.485714286,Heat,Miami,240,9,11,6,32,38,24,6,3,16,13,82,-27
22000275,DEN,1610612743,42,92,0.457,14,43,0.325581395,1,28,49,0.571428571,Nuggets,Denver,240,11,11,12,37,49,29,14,4,13,12,109,27
22000276,PHI,1610612755,41,85,0.482,9,25,0.36,0.615,32,60,0.533333333,76ers,Philadelphia,240,16,26,7,31,38,24,10,7,11,24,107,1
22000276,LAL,1610612747,41,86,0.477,8,24,0.333333333,0.64,33,62,0.532258065,Lakers,Los Angeles,240,16,25,6,31,37,20,5,2,11,20,106,-1
22000277,TOR,1610612761,38,94,0.404,22,55,0.4,0.833,16,39,0.41025641,Raptors,Toronto,240,10,12,10,36,46,26,8,8,11,20,108,-7
22000277,MIL,1610612749,40,93,0.43,16,44,0.363636364,0.731,24,49,0.489795918,Bucks,Milwaukee,240,19,26,14,45,59,30,9,3,14,14,115,7
22000278,MEM,1610612763,40,85,0.471,9,28,0.321428571,0.857,31,57,0.543859649,Grizzlies,Memphis,240,12,14,10,41,51,27,7,7,20,20,101,11
22000278,CHI,1610612741,36,86,0.419,5,31,0.161290323,0.765,31,55,0.563636364,Bulls,Chicago,240,13,17,8,32,40,23,8,3,17,16,90,-11
22000279,WAS,1610612764,37,92,0.402,13,38,0.342105263,0.905,24,54,0.444444444,Wizards,Washington,240,19,21,11,28,39,29,11,2,11,20,106,-18
22000279,NOP,1610612740,46,89,0.517,17,43,0.395348837,0.625,29,46,0.630434783,Pelicans,New Orleans,240,15,24,12,38,50,27,7,4,14,17,124,18
22000280,SAS,1610612759,46,82,0.561,8,28,0.285714286,0.625,38,54,0.703703704,Spurs,San Antonio,240,10,16,9,37,46,22,5,4,19,16,110,4
22000280,BOS,1610612738,42,98,0.429,10,30,0.333333333,0.857,32,68,0.470588235,Celtics,Boston,240,12,14,13,26,39,15,10,4,10,14,106,-4
22000281,PHX,1610612756,36,95,0.379,15,43,0.348837209,0.833,21,52,0.403846154,Suns,Phoenix,240,10,12,9,40,49,19,7,3,13,16,97,-5
22000281,OKC,1610612760,38,85,0.447,16,40,0.4,0.714,22,45,0.488888889,Thunder,Oklahoma City,240,10,14,5,43,48,21,7,8,14,19,102,5
22000282,UTA,1610612762,42,91,0.462,16,41,0.390243902,0.762,26,50,0.52,Jazz,Utah,240,16,21,11,39,50,20,7,7,9,18,116,12
22000282,DAL,1610612742,42,91,0.462,12,35,0.342857143,0.889,30,56,0.535714286,Mavericks,Dallas,240,8,9,4,32,36,22,4,7,8,12,104,-12
22000283,MIN,1610612750,37,87,0.425,14,36,0.388888889,0.697,23,51,0.450980392,Timberwolves,Minnesota,240,23,33,11,28,39,23,12,7,17,22,111,-12
22000283,GSW,1610612744,45,85,0.529,15,34,0.441176471,0.783,30,51,0.588235294,Warriors,Golden State,240,18,23,11,35,46,32,11,5,21,28,123,12
22000284,LAL,1610612747,36,88,0.409,12,28,0.428571429,0.667,24,60,0.4,Lakers,Los Angeles,240,8,12,12,32,44,25,2,3,11,16,92,-15
22000284,DET,1610612765,40,87,0.46,14,36,0.388888889,1,26,51,0.509803922,Pistons,Detroit,240,13,13,5,33,38,27,4,2,8,18,107,15
22000285,MIA,1610612748,40,90,0.444,13,33,0.393939394,0.8,27,57,0.473684211,Heat,Miami,240,12,15,8,37,45,24,5,1,13,18,105,-4
22000285,LAC,1610612746,36,87,0.414,17,42,0.404761905,0.909,19,45,0.422222222,Clippers,LA,240,20,22,13,42,55,22,11,4,12,20,109,4
22000286,PHX,1610612756,41,88,0.466,11,32,0.34375,0.913,30,56,0.535714286,Suns,Phoenix,240,21,23,9,48,57,34,7,1,14,14,114,21
22000286,GSW,1610612744,38,99,0.384,11,38,0.289473684,0.75,27,61,0.442622951,Warriors,Golden State,240,6,8,12,36,48,21,8,1,13,19,93,-21
22000287,POR,1610612757,39,93,0.419,17,41,0.414634146,0.75,22,52,0.423076923,Trail Blazers,Portland,240,6,8,10,39,49,16,6,7,15,16,101,-3
22000287,HOU,1610612745,38,90,0.422,13,47,0.276595745,0.833,25,43,0.581395349,Rockets,Houston,240,15,18,10,37,47,19,8,7,13,12,104,3
22000288,IND,1610612754,42,87,0.483,11,35,0.314285714,0.769,31,52,0.596153846,Pacers,Indiana,240,10,13,9,30,39,30,7,4,16,13,105,-3
22000288,CHA,1610612766,43,85,0.506,16,37,0.432432432,0.667,27,48,0.5625,Hornets,Charlotte,240,6,9,9,33,42,35,7,5,17,13,108,3
22000289,ORL,1610612753,32,89,0.36,10,33,0.303030303,0.889,22,56,0.392857143,Magic,Orlando,240,16,18,12,37,49,20,6,2,17,12,90,-26
22000289,LAC,1610612746,46,94,0.489,13,37,0.351351351,1,33,57,0.578947368,Clippers,LA,240,11,11,9,40,49,25,8,5,11,15,116,26
22000290,WAS,1610612764,31,85,0.365,7,28,0.25,0.816,24,57,0.421052632,Wizards,Washington,240,31,38,13,34,47,13,6,4,12,27,100,-16
22000290,ATL,1610612737,39,87,0.448,12,37,0.324324324,0.765,27,50,0.54,Hawks,Atlanta,240,26,34,12,35,47,16,5,4,13,30,116,16
22000291,NYK,1610612752,39,80,0.487,10,27,0.37037037,0.875,29,53,0.547169811,Knicks,New York,240,14,16,8,33,41,20,8,6,13,24,102,21
22000291,CLE,1610612739,29,84,0.345,8,26,0.307692308,0.833,21,58,0.362068966,Cavaliers,Cleveland,240,15,18,14,29,43,15,8,5,14,20,81,-21
22000292,TOR,1610612761,42,86,0.488,13,32,0.40625,0.818,29,54,0.537037037,Raptors,Toronto,240,27,33,12,23,35,20,14,2,15,27,124,-2
22000292,SAC,1610612758,43,78,0.551,16,36,0.444444444,0.774,27,42,0.642857143,Kings,Sacramento,240,24,31,11,27,38,31,7,5,22,25,126,2
22000293,NOP,1610612740,45,96,0.469,21,48,0.4375,0.714,24,48,0.5,Pelicans,New Orleans,240,20,28,12,33,45,32,7,3,9,16,131,5
22000293,MIL,1610612749,48,96,0.5,13,35,0.371428571,0.773,35,61,0.573770492,Bucks,Milwaukee,240,17,22,12,37,49,29,5,5,12,19,126,-5
22000294,PHI,1610612755,39,87,0.448,8,16,0.5,0.842,31,71,0.436619718,76ers,Philadelphia,240,32,38,12,39,51,20,11,6,10,17,118,24
22000294,MIN,1610612750,35,82,0.427,10,33,0.303030303,0.778,25,49,0.510204082,Timberwolves,Minnesota,240,14,18,4,34,38,20,3,4,18,29,94,-24
22000295,OKC,1610612760,40,86,0.465,16,38,0.421052632,0.853,24,48,0.5,Thunder,Oklahoma City,240,29,34,6,30,36,23,4,4,12,12,125,-22
22000295,BKN,1610612751,57,100,0.57,19,45,0.422222222,0.875,38,55,0.690909091,Nets,Brooklyn,240,14,16,10,40,50,33,7,4,11,25,147,22
22000296,SAS,1610612759,44,81,0.543,10,23,0.434782609,0.808,34,58,0.586206897,Spurs,San Antonio,240,21,26,9,32,41,29,8,1,12,18,119,10
22000296,DEN,1610612743,41,78,0.526,14,31,0.451612903,0.65,27,47,0.574468085,Nuggets,Denver,240,13,20,7,30,37,25,8,5,15,15,109,-10
22000297,UTA,1610612762,38,87,0.437,20,48,0.416666667,0.923,18,39,0.461538462,Jazz,Utah,240,24,26,17,39,56,21,8,5,15,25,120,19
22000297,DAL,1610612742,37,86,0.43,9,33,0.272727273,0.667,28,53,0.528301887,Mavericks,Dallas,240,18,27,8,32,40,20,6,4,11,27,101,-19
22000298,POR,1610612757,45,88,0.511,17,42,0.404761905,0.842,28,46,0.608695652,Trail Blazers,Portland,240,16,19,9,26,35,20,11,1,8,17,123,1
22000298,CHI,1610612741,43,85,0.506,21,45,0.466666667,1,22,40,0.55,Bulls,Chicago,240,15,15,11,32,43,31,5,2,15,14,122,-1
22000299,MIL,1610612749,40,82,0.488,18,45,0.4,0.667,22,37,0.594594595,Bucks,Milwaukee,240,16,24,8,38,46,22,6,6,15,17,114,-12
22000299,CHA,1610612766,44,92,0.478,21,44,0.477272727,0.85,23,48,0.479166667,Hornets,Charlotte,240,17,20,7,34,41,32,8,5,9,20,126,12
22000300,NOP,1610612740,41,91,0.451,12,41,0.292682927,0.621,29,50,0.58,Pelicans,New Orleans,240,18,29,10,38,48,27,11,7,14,14,112,-14
22000300,HOU,1610612745,45,92,0.489,20,46,0.434782609,0.8,25,46,0.543478261,Rockets,Houston,240,16,20,7,38,45,32,8,5,14,24,126,14
22000301,SAC,1610612758,41,85,0.482,17,45,0.377777778,0.455,24,40,0.6,Kings,Sacramento,240,5,11,12,29,41,22,12,3,17,21,104,-1
22000301,MIA,1610612748,36,77,0.468,11,32,0.34375,0.846,25,45,0.555555556,Heat,Miami,240,22,26,9,30,39,25,5,4,15,14,105,1
22000302,LAL,1610612747,37,84,0.44,9,31,0.290322581,0.684,28,53,0.528301887,Lakers,Los Angeles,240,13,19,13,32,45,20,8,4,14,15,96,1
22000302,BOS,1610612738,40,82,0.488,6,21,0.285714286,0.643,34,61,0.557377049,Celtics,Boston,240,9,14,9,33,42,24,10,6,15,16,95,-1
22000303,PHX,1610612756,37,81,0.457,10,22,0.454545455,0.871,27,59,0.457627119,Suns,Phoenix,240,27,31,9,33,42,22,9,0,13,19,111,6
22000303,DAL,1610612742,44,83,0.53,9,29,0.310344828,0.571,35,54,0.648148148,Mavericks,Dallas,240,8,14,5,32,37,22,5,4,15,26,105,-6
22000304,SAS,1610612759,39,83,0.47,13,29,0.448275862,0.808,26,54,0.481481481,Spurs,San Antonio,240,21,26,8,30,38,25,7,5,13,16,112,-17
22000304,MEM,1610612763,51,91,0.56,17,35,0.485714286,0.667,34,56,0.607142857,Grizzlies,Memphis,240,10,15,10,35,45,34,7,7,14,23,129,17
22000305,GSW,1610612744,47,89,0.528,17,36,0.472222222,0.7,30,53,0.566037736,Warriors,Golden State,240,7,10,8,39,47,34,6,5,14,23,118,27
22000305,DET,1610612765,29,77,0.377,9,36,0.25,0.75,20,41,0.487804878,Pistons,Detroit,240,24,32,7,31,38,17,7,4,14,14,91,-27
22000306,UTA,1610612762,32,75,0.427,20,47,0.425531915,0.846,12,28,0.428571429,Jazz,Utah,240,33,39,10,28,38,28,3,4,14,21,117,-11
22000306,DEN,1610612743,47,87,0.54,18,28,0.642857143,0.842,29,59,0.491525424,Nuggets,Denver,240,16,19,7,32,39,28,8,2,8,27,128,11
22000307,PHI,1610612755,45,92,0.489,8,26,0.307692308,0.677,37,66,0.560606061,76ers,Philadelphia,240,21,31,14,30,44,20,9,8,12,21,119,9
22000307,IND,1610612754,41,84,0.488,10,28,0.357142857,0.818,31,56,0.553571429,Pacers,Indiana,240,18,22,9,32,41,21,6,7,17,25,110,-9
22000308,NYK,1610612752,41,85,0.482,10,27,0.37037037,0.821,31,58,0.534482759,Knicks,New York,240,23,28,10,26,36,21,5,5,7,20,115,-14
22000308,LAC,1610612746,44,81,0.543,17,38,0.447368421,0.857,27,43,0.627906977,Clippers,LA,240,24,28,7,31,38,26,2,4,7,14,129,14
22000309,TOR,1610612761,41,90,0.456,12,39,0.307692308,0.955,29,51,0.568627451,Raptors,Toronto,240,21,22,9,39,48,27,8,5,11,22,115,13
22000309,ORL,1610612753,33,82,0.402,13,36,0.361111111,0.821,20,46,0.434782609,Magic,Orlando,240,23,28,6,36,42,22,8,5,10,18,102,-13
22000310,WAS,1610612764,56,108,0.519,12,39,0.307692308,0.781,44,69,0.637681159,Wizards,Washington,240,25,32,11,28,39,24,10,2,7,22,149,3
22000310,BKN,1610612751,50,88,0.568,19,36,0.527777778,0.818,31,52,0.596153846,Nets,Brooklyn,240,27,33,7,38,45,33,6,5,17,24,146,-3
22000311,MIN,1610612750,41,91,0.451,16,40,0.4,0.733,25,51,0.490196078,Timberwolves,Minnesota,240,11,15,7,27,34,24,10,11,8,25,109,5
22000311,CLE,1610612739,41,84,0.488,4,16,0.25,0.783,37,68,0.544117647,Cavaliers,Cleveland,240,18,23,10,45,55,20,3,3,19,14,104,-5
22000312,MIN,1610612750,40,102,0.392,11,38,0.289473684,0.636,29,64,0.453125,Timberwolves,Minnesota,240,7,11,15,30,45,20,4,1,8,21,98,-2
22000312,CLE,1610612739,35,84,0.417,7,22,0.318181818,0.742,28,62,0.451612903,Cavaliers,Cleveland,240,23,31,15,37,52,26,4,12,13,12,100,2
22000313,LAL,1610612747,40,77,0.519,7,23,0.304347826,0.833,33,54,0.611111111,Lakers,Los Angeles,240,20,24,4,27,31,24,10,7,11,20,107,8
22000313,ATL,1610612737,37,78,0.474,11,29,0.379310345,0.824,26,49,0.530612245,Hawks,Atlanta,240,14,17,6,30,36,27,8,3,17,21,99,-8
22000314,MIA,1610612748,43,91,0.473,19,46,0.413043478,0.64,24,45,0.533333333,Heat,Miami,265,16,25,10,38,48,28,8,7,15,26,121,-8
22000314,CHA,1610612766,43,95,0.453,21,41,0.512195122,0.846,22,54,0.407407407,Hornets,Charlotte,265,22,26,13,31,44,31,6,4,11,22,129,8
22000315,NYK,1610612752,37,87,0.425,6,29,0.206896552,0.846,31,58,0.534482759,Knicks,New York,240,22,26,11,34,45,21,6,6,11,19,102,-8
22000315,CHI,1610612741,42,88,0.477,11,34,0.323529412,0.75,31,54,0.574074074,Bulls,Chicago,240,15,20,7,33,40,30,3,1,12,19,110,8
22000316,POR,1610612757,39,104,0.375,15,42,0.357142857,1,24,62,0.387096774,Trail Blazers,Portland,240,13,13,14,31,45,19,8,6,11,10,106,-28
22000316,MIL,1610612749,53,96,0.552,21,42,0.5,0.583,32,54,0.592592593,Bucks,Milwaukee,240,7,12,9,44,53,38,10,7,12,13,134,28
22000317,SAC,1610612758,42,88,0.477,14,43,0.325581395,0.769,28,45,0.622222222,Kings,Sacramento,240,20,26,13,39,52,31,3,8,20,18,118,9
22000317,NOP,1610612740,40,101,0.396,9,30,0.3,0.833,31,71,0.436619718,Pelicans,New Orleans,240,20,24,17,29,46,22,11,5,10,22,109,-9
22000318,OKC,1610612760,39,89,0.438,13,34,0.382352941,0.789,26,55,0.472727273,Thunder,Oklahoma City,240,15,19,8,37,45,21,8,8,16,13,106,-30
22000318,HOU,1610612745,49,102,0.48,28,52,0.538461538,0.909,21,50,0.42,Rockets,Houston,240,10,11,10,40,50,30,8,6,11,20,136,30
22000319,PHX,1610612756,43,92,0.467,13,35,0.371428571,0.833,30,57,0.526315789,Suns,Phoenix,240,10,12,11,34,45,19,7,3,16,24,109,1
22000319,DAL,1610612742,37,86,0.43,10,32,0.3125,0.96,27,54,0.5,Mavericks,Dallas,240,24,25,7,35,42,16,9,7,14,17,108,-1
22000320,SAS,1610612759,37,89,0.416,13,37,0.351351351,0.682,24,52,0.461538462,Spurs,San Antonio,240,15,22,10,32,42,28,8,7,14,13,102,-31
22000320,MEM,1610612763,52,93,0.559,15,30,0.5,0.778,37,63,0.587301587,Grizzlies,Memphis,240,14,18,10,43,53,37,11,11,9,16,133,31
22000321,DET,1610612765,44,81,0.543,15,35,0.428571429,0.8,29,46,0.630434783,Pistons,Detroit,240,16,20,7,23,30,27,4,2,13,12,119,-15
22000321,DEN,1610612743,56,94,0.596,14,31,0.451612903,0.889,42,63,0.666666667,Nuggets,Denver,240,8,9,13,31,44,36,7,5,10,20,134,15
22000322,MEM,1610612763,42,93,0.452,9,25,0.36,0.958,33,68,0.485294118,Grizzlies,Memphis,240,23,24,10,26,36,27,11,7,16,22,116,-18
22000322,IND,1610612754,49,82,0.598,16,29,0.551724138,0.69,33,53,0.622641509,Pacers,Indiana,240,20,29,9,33,42,30,8,8,18,19,134,18
22000323,TOR,1610612761,40,83,0.482,20,45,0.444444444,0.92,20,38,0.526315789,Raptors,Toronto,240,23,25,6,34,40,32,14,4,11,18,123,15
22000323,ORL,1610612753,41,89,0.461,14,38,0.368421053,0.857,27,51,0.529411765,Magic,Orlando,240,12,14,9,37,46,24,4,4,16,22,108,-15
22000324,LAC,1610612746,45,99,0.455,15,36,0.416666667,0.882,30,63,0.476190476,Clippers,LA,240,15,17,11,28,39,21,12,5,8,18,120,-4
22000324,BKN,1610612751,45,79,0.57,13,31,0.419354839,0.808,32,48,0.666666667,Nets,Brooklyn,240,21,26,6,38,44,25,6,4,16,17,124,4
22000325,UTA,1610612762,38,82,0.463,16,42,0.380952381,0.862,22,40,0.55,Jazz,Utah,240,25,29,8,36,44,23,9,6,13,17,117,12
22000325,DET,1610612765,39,93,0.419,9,27,0.333333333,0.9,30,66,0.454545455,Pistons,Detroit,240,18,20,12,34,46,18,7,5,15,21,105,-12
22000326,GSW,1610612744,38,83,0.458,15,37,0.405405405,0.696,23,46,0.5,Warriors,Golden State,240,16,23,6,30,36,30,9,4,11,23,107,-4
22000326,BOS,1610612738,39,84,0.464,13,34,0.382352941,0.741,26,50,0.52,Celtics,Boston,240,20,27,12,39,51,16,3,4,15,20,111,4
22000327,PHI,1610612755,41,79,0.519,10,24,0.416666667,0.813,31,55,0.563636364,76ers,Philadelphia,240,26,32,10,30,40,23,9,6,18,21,118,7
22000327,CHA,1610612766,39,87,0.448,14,37,0.378378378,0.826,25,50,0.5,Hornets,Charlotte,240,19,23,10,27,37,28,5,4,16,22,111,-7
22000328,LAC,1610612746,44,79,0.557,20,34,0.588235294,0.765,24,45,0.533333333,Clippers,LA,240,13,17,8,38,46,22,4,6,14,20,121,22
22000328,CLE,1610612739,41,92,0.446,4,10,0.4,0.765,37,82,0.451219512,Cavaliers,Cleveland,240,13,17,11,26,37,21,8,6,8,14,99,-22
22000329,MIL,1610612749,48,102,0.471,21,48,0.4375,0.929,27,54,0.5,Bucks,Milwaukee,240,13,14,11,42,53,33,13,7,12,11,130,20
22000329,IND,1610612754,43,95,0.453,11,34,0.323529412,0.867,32,61,0.524590164,Pacers,Indiana,240,13,15,8,38,46,28,7,6,14,13,110,-20
22000330,DAL,1610612742,43,93,0.462,13,40,0.325,0.92,30,53,0.566037736,Mavericks,Dallas,240,23,25,13,32,45,27,8,7,10,19,122,6
22000330,ATL,1610612737,45,90,0.5,14,38,0.368421053,0.706,31,52,0.596153846,Hawks,Atlanta,240,12,17,13,33,46,31,6,4,16,20,116,-6
22000331,WAS,1610612764,35,84,0.417,15,37,0.405405405,0.72,20,47,0.425531915,Wizards,Washington,240,18,25,14,35,49,20,6,5,17,17,103,3
22000331,MIA,1610612748,36,83,0.434,12,35,0.342857143,0.727,24,48,0.5,Heat,Miami,240,16,22,9,35,44,24,11,2,13,21,100,-3
22000332,NYK,1610612752,43,89,0.483,11,22,0.5,0.667,32,67,0.47761194,Knicks,New York,240,10,15,11,36,47,19,5,4,17,18,107,4
22000332,CHI,1610612741,43,88,0.489,6,36,0.166666667,0.688,37,52,0.711538462,Bulls,Chicago,240,11,16,6,32,38,25,11,3,9,14,103,-4
22000333,OKC,1610612760,36,83,0.434,10,33,0.303030303,0.846,26,50,0.52,Thunder,Oklahoma City,240,22,26,5,46,51,19,13,5,21,14,104,17
22000333,HOU,1610612745,33,86,0.384,12,46,0.260869565,0.692,21,40,0.525,Rockets,Houston,240,9,13,5,36,41,21,11,4,20,18,87,-17
22000334,SAS,1610612759,43,96,0.448,7,26,0.269230769,0.75,36,70,0.514285714,Spurs,San Antonio,240,18,24,7,38,45,28,5,6,7,13,111,3
22000334,MIN,1610612750,43,94,0.457,13,33,0.393939394,0.818,30,61,0.491803279,Timberwolves,Minnesota,240,9,11,9,40,49,22,6,9,10,21,108,-3
22000335,PHX,1610612756,38,82,0.463,8,35,0.228571429,0.85,30,47,0.638297872,Suns,Phoenix,240,17,20,11,28,39,26,3,6,14,18,101,-22
22000335,NOP,1610612740,46,90,0.511,14,33,0.424242424,0.81,32,57,0.561403509,Pelicans,New Orleans,240,17,21,12,32,44,30,7,3,7,20,123,22
22000336,SAC,1610612758,42,92,0.457,13,37,0.351351351,0.826,29,55,0.527272727,Kings,Sacramento,240,19,23,12,32,44,23,7,2,10,19,116,5
22000336,BOS,1610612738,39,86,0.453,11,33,0.333333333,0.759,28,53,0.528301887,Celtics,Boston,240,22,29,11,34,45,28,9,3,13,21,111,-5
22000337,POR,1610612757,45,98,0.459,13,31,0.419354839,0.783,32,67,0.47761194,Trail Blazers,Portland,240,18,23,19,34,53,17,8,5,11,18,121,16
22000337,PHI,1610612755,39,81,0.481,7,27,0.259259259,0.833,32,54,0.592592593,76ers,Philadelphia,240,20,24,8,29,37,19,6,3,18,15,105,-16
22000338,UTA,1610612762,44,91,0.484,13,27,0.481481481,0.846,31,64,0.484375,Jazz,Utah,240,11,13,12,40,52,19,7,4,14,20,112,21
22000338,ATL,1610612737,32,98,0.327,9,31,0.290322581,0.947,23,67,0.343283582,Hawks,Atlanta,240,18,19,18,31,49,19,8,1,11,15,91,-21
22000339,GSW,1610612744,51,89,0.573,22,43,0.511627907,0.852,29,46,0.630434783,Warriors,Golden State,240,23,27,4,41,45,37,6,6,8,19,147,31
22000339,DAL,1610612742,38,92,0.413,20,50,0.4,0.87,18,42,0.428571429,Mavericks,Dallas,240,20,23,10,32,42,26,2,3,10,24,116,-31
22000340,MEM,1610612763,37,87,0.425,12,35,0.342857143,0.708,25,52,0.480769231,Grizzlies,Memphis,240,17,24,11,32,43,28,10,6,13,15,103,-12
22000340,HOU,1610612745,41,87,0.471,19,45,0.422222222,0.824,22,42,0.523809524,Rockets,Houston,240,14,17,8,36,44,26,8,3,14,19,115,12
22000341,LAL,1610612747,46,81,0.568,8,24,0.333333333,0.636,38,57,0.666666667,Lakers,Los Angeles,240,14,22,8,32,40,29,10,7,16,19,114,21
22000341,DEN,1610612743,36,92,0.391,8,28,0.285714286,0.867,28,64,0.4375,Nuggets,Denver,240,13,15,16,26,42,19,9,2,15,23,93,-21
22000342,UTA,1610612762,48,87,0.552,26,50,0.52,0.889,22,37,0.594594595,Jazz,Utah,240,16,18,6,38,44,32,5,9,16,19,138,17
22000342,CHA,1610612766,48,104,0.462,11,35,0.314285714,0.824,37,69,0.536231884,Hornets,Charlotte,240,14,17,14,26,40,26,9,2,7,17,121,-17
22000343,NOP,1610612740,41,76,0.539,13,25,0.52,0.731,28,51,0.549019608,Pelicans,New Orleans,240,19,26,11,39,50,23,5,6,19,17,114,1
22000343,IND,1610612754,41,93,0.441,20,42,0.476190476,0.688,21,51,0.411764706,Pacers,Indiana,240,11,16,10,27,37,31,9,6,10,21,113,-1
22000344,ORL,1610612753,42,81,0.519,11,27,0.407407407,0.757,31,54,0.574074074,Magic,Orlando,240,28,37,10,39,49,27,5,2,15,22,123,4
22000344,CHI,1610612741,46,96,0.479,9,30,0.3,0.9,37,66,0.560606061,Bulls,Chicago,240,18,20,10,30,40,27,9,5,8,22,119,-4
22000345,TOR,1610612761,49,97,0.505,13,32,0.40625,0.857,36,65,0.553846154,Raptors,Toronto,240,12,14,12,29,41,22,10,6,10,25,123,6
22000345,BKN,1610612751,39,80,0.487,17,42,0.404761905,0.759,22,38,0.578947368,Nets,Brooklyn,240,22,29,8,32,40,29,5,6,18,19,117,-6
22000346,MIL,1610612749,50,97,0.515,7,22,0.318181818,0.727,43,75,0.573333333,Bucks,Milwaukee,240,16,22,13,41,54,28,6,7,11,18,123,18
22000346,CLE,1610612739,41,92,0.446,11,32,0.34375,0.75,30,60,0.5,Cavaliers,Cleveland,240,12,16,6,30,36,23,7,9,11,19,105,-18
22000347,WAS,1610612764,33,89,0.371,8,33,0.242424242,0.875,25,56,0.446428571,Wizards,Washington,240,21,24,12,28,40,19,7,9,17,20,95,-27
22000347,MIA,1610612748,43,86,0.5,16,36,0.444444444,0.87,27,50,0.54,Heat,Miami,240,20,23,9,39,48,27,9,7,16,20,122,27
22000348,OKC,1610612760,39,85,0.459,13,34,0.382352941,0.706,26,51,0.509803922,Thunder,Oklahoma City,240,12,17,8,36,44,28,10,7,17,7,103,-3
22000348,MIN,1610612750,41,94,0.436,16,40,0.4,0.889,25,54,0.462962963,Timberwolves,Minnesota,240,8,9,10,33,43,27,10,4,15,15,106,3
22000349,PHX,1610612756,42,85,0.494,12,32,0.375,0.813,30,53,0.566037736,Suns,Phoenix,240,13,16,10,40,50,26,7,3,21,26,109,17
22000349,DET,1610612765,34,91,0.374,7,36,0.194444444,0.607,27,55,0.490909091,Pistons,Detroit,240,17,28,17,28,45,20,8,6,13,16,92,-17
22000350,LAC,1610612746,42,81,0.519,14,32,0.4375,0.81,28,49,0.571428571,Clippers,LA,240,17,21,10,37,47,26,5,4,16,17,115,-4
22000350,BOS,1610612738,43,90,0.478,16,38,0.421052632,0.81,27,52,0.519230769,Celtics,Boston,240,17,21,9,25,34,21,8,1,6,16,119,4
22000351,POR,1610612757,37,89,0.416,17,47,0.361702128,0.5,20,42,0.476190476,Trail Blazers,Portland,240,8,16,11,30,41,15,7,7,11,15,99,-11
22000351,NYK,1610612752,44,88,0.5,13,30,0.433333333,0.692,31,58,0.534482759,Knicks,New York,240,9,13,8,43,51,20,5,5,14,19,110,11
22000352,SAC,1610612758,44,91,0.484,14,35,0.4,0.708,30,56,0.535714286,Kings,Sacramento,240,17,24,10,35,45,30,5,7,7,11,119,5
22000352,DEN,1610612743,45,97,0.464,13,35,0.371428571,0.786,32,62,0.516129032,Nuggets,Denver,240,11,14,13,34,47,30,3,9,9,18,114,-5
22000353,ORL,1610612753,37,95,0.389,6,27,0.222222222,1,31,68,0.455882353,Magic,Orlando,240,12,12,15,32,47,17,5,10,11,10,92,-26
22000353,CHI,1610612741,47,91,0.516,15,30,0.5,0.692,32,61,0.524590164,Bulls,Chicago,240,9,13,11,36,47,28,6,10,10,12,118,26
22000354,PHI,1610612755,48,94,0.511,10,27,0.37037037,0.818,38,67,0.567164179,76ers,Philadelphia,240,18,22,13,38,51,27,12,4,15,15,124,16
22000354,BKN,1610612751,39,88,0.443,15,41,0.365853659,0.882,24,47,0.510638298,Nets,Brooklyn,240,15,17,8,26,34,21,6,3,17,18,108,-16
22000355,NOP,1610612740,45,87,0.517,15,33,0.454545455,0.619,30,54,0.555555556,Pelicans,New Orleans,240,13,21,8,34,42,27,3,9,7,15,118,9
22000355,MEM,1610612763,40,90,0.444,13,39,0.333333333,0.842,27,51,0.529411765,Grizzlies,Memphis,240,16,19,11,34,45,27,5,5,9,17,109,-9
22000356,TOR,1610612761,41,97,0.423,13,38,0.342105263,0.765,28,59,0.474576271,Raptors,Toronto,240,26,34,14,24,38,24,9,5,6,27,121,-11
22000356,ATL,1610612737,42,74,0.568,19,36,0.527777778,0.879,23,38,0.605263158,Hawks,Atlanta,240,29,33,4,39,43,31,1,10,18,25,132,11
22000357,MIL,1610612749,47,86,0.547,16,34,0.470588235,0.609,31,52,0.596153846,Bucks,Milwaukee,240,14,23,6,37,43,25,10,2,8,20,124,25
22000357,CLE,1610612739,39,86,0.453,6,28,0.214285714,0.714,33,58,0.568965517,Cavaliers,Cleveland,240,15,21,8,32,40,21,4,1,13,19,99,-25
22000358,SAS,1610612759,37,87,0.425,8,25,0.32,0.806,29,62,0.467741935,Spurs,San Antonio,240,29,36,7,37,44,22,6,7,10,18,111,5
22000358,HOU,1610612745,38,88,0.432,12,38,0.315789474,0.72,26,50,0.52,Rockets,Houston,240,18,25,6,40,46,21,5,6,12,25,106,-5
22000359,OKC,1610612760,46,90,0.511,12,33,0.363636364,0.8,34,57,0.596491228,Thunder,Oklahoma City,240,16,20,8,35,43,25,8,1,15,19,120,2
22000359,MIN,1610612750,47,93,0.505,12,36,0.333333333,0.545,35,57,0.614035088,Timberwolves,Minnesota,240,12,22,13,27,40,27,12,3,13,15,118,-2
22000360,GSW,1610612744,46,86,0.535,20,45,0.444444444,0.87,26,41,0.634146341,Warriors,Golden State,240,20,23,6,34,40,27,11,4,16,24,132,-2
22000360,DAL,1610612742,44,96,0.458,21,47,0.446808511,0.833,23,49,0.469387755,Mavericks,Dallas,240,25,30,15,32,47,27,5,0,14,19,134,2
22000361,LAL,1610612747,51,91,0.56,9,19,0.473684211,0.857,42,72,0.583333333,Lakers,Los Angeles,290,24,28,9,32,41,32,12,5,23,24,135,6
22000361,DET,1610612765,45,94,0.479,16,42,0.380952381,0.821,29,52,0.557692308,Pistons,Detroit,290,23,28,9,26,35,31,13,4,20,31,129,-6
22000362,POR,1610612757,36,91,0.396,10,36,0.277777778,0.679,26,55,0.472727273,Trail Blazers,Portland,240,19,28,13,34,47,18,7,3,8,17,101,-8
22000362,CHA,1610612766,39,83,0.47,18,43,0.418604651,0.765,21,40,0.525,Hornets,Charlotte,240,13,17,7,39,46,26,6,8,14,25,109,8
22000363,UTA,1610612762,38,92,0.413,13,42,0.30952381,0.667,25,50,0.5,Jazz,Utah,240,14,21,16,44,60,22,2,4,14,17,103,8
22000363,IND,1610612754,37,93,0.398,8,29,0.275862069,0.722,29,64,0.453125,Pacers,Indiana,240,13,18,8,37,45,23,9,6,9,22,95,-8
22000364,NYK,1610612752,38,85,0.447,16,42,0.380952381,0.733,22,43,0.511627907,Knicks,New York,240,11,15,10,34,44,23,8,2,12,20,103,-6
22000364,MIA,1610612748,40,83,0.482,13,35,0.371428571,0.8,27,48,0.5625,Heat,Miami,240,16,20,6,38,44,25,6,1,11,15,109,6
22000365,PHX,1610612756,40,82,0.488,8,29,0.275862069,1,32,53,0.603773585,Suns,Phoenix,240,12,12,9,41,50,25,4,5,10,15,100,9
22000365,BOS,1610612738,33,93,0.355,17,44,0.386363636,0.667,16,49,0.326530612,Celtics,Boston,240,8,12,13,28,41,19,6,2,5,11,91,-9
22000366,SAC,1610612758,46,94,0.489,10,29,0.344827586,0.733,36,65,0.553846154,Kings,Sacramento,240,11,15,11,41,52,25,5,4,12,18,113,3
22000366,LAC,1610612746,41,99,0.414,8,28,0.285714286,0.87,33,71,0.464788732,Clippers,LA,240,20,23,16,37,53,19,8,5,9,16,110,-3
22000367,HOU,1610612745,35,86,0.407,13,47,0.276595745,0.688,22,39,0.564102564,Rockets,Houston,240,11,16,8,31,39,20,9,4,11,18,94,-25
22000367,CHA,1610612766,44,90,0.489,19,41,0.463414634,0.923,25,49,0.510204082,Hornets,Charlotte,240,12,13,11,40,51,28,5,6,14,15,119,25
22000368,WAS,1610612764,36,86,0.419,6,26,0.230769231,0.75,30,60,0.5,Wizards,Washington,240,27,36,10,37,47,23,8,4,13,21,105,4
22000368,CHI,1610612741,36,85,0.424,9,30,0.3,0.833,27,55,0.490909091,Bulls,Chicago,240,20,24,10,40,50,23,6,3,16,26,101,-4
22000369,TOR,1610612761,42,77,0.545,20,37,0.540540541,0.923,22,40,0.55,Raptors,Toronto,240,24,26,7,30,37,28,11,2,14,24,128,15
22000369,MEM,1610612763,37,87,0.425,13,39,0.333333333,0.897,24,48,0.5,Grizzlies,Memphis,240,26,29,19,23,42,27,7,4,15,18,113,-15
22000370,MIN,1610612750,42,91,0.462,18,42,0.428571429,0.714,24,49,0.489795918,Timberwolves,Minnesota,240,20,28,7,34,41,27,9,5,9,27,122,-5
22000370,DAL,1610612742,45,87,0.517,12,34,0.352941176,0.833,33,53,0.622641509,Mavericks,Dallas,240,25,30,10,38,48,30,4,6,14,22,127,5
22000371,SAS,1610612759,39,96,0.406,11,31,0.35483871,0.842,28,65,0.430769231,Spurs,San Antonio,240,16,19,10,36,46,24,12,6,10,16,105,5
22000371,GSW,1610612744,38,86,0.442,13,37,0.351351351,0.733,25,49,0.510204082,Warriors,Golden State,240,11,15,6,43,49,29,4,6,20,19,100,-5
22000372,PHX,1610612756,47,90,0.522,11,24,0.458333333,0.737,36,66,0.545454545,Suns,Phoenix,240,14,19,14,27,41,29,7,6,10,20,119,6
22000372,CLE,1610612739,44,86,0.512,8,24,0.333333333,0.68,36,62,0.580645161,Cavaliers,Cleveland,240,17,25,9,30,39,23,5,5,10,20,113,-6
22000373,MIL,1610612749,45,89,0.506,16,40,0.4,0.864,29,49,0.591836735,Bucks,Milwaukee,240,19,22,11,39,50,24,7,7,10,19,125,13
22000373,DEN,1610612743,41,94,0.436,15,36,0.416666667,0.938,26,58,0.448275862,Nuggets,Denver,240,15,16,8,30,38,22,5,4,9,15,112,-13
22000374,OKC,1610612760,43,110,0.391,12,38,0.315789474,0.737,31,72,0.430555556,Thunder,Oklahoma City,265,14,19,15,40,55,23,6,4,12,23,112,-7
22000374,LAL,1610612747,44,95,0.463,9,38,0.236842105,0.759,35,57,0.614035088,Lakers,Los Angeles,265,22,29,10,49,59,28,7,12,15,19,119,7
22000375,DET,1610612765,47,84,0.56,13,29,0.448275862,0.714,34,55,0.618181818,Pistons,Detroit,240,15,21,7,30,37,28,10,6,13,16,122,11
22000375,BKN,1610612751,43,86,0.5,11,30,0.366666667,0.875,32,56,0.571428571,Nets,Brooklyn,240,14,16,8,26,34,30,8,6,15,22,111,-11
22000376,NYK,1610612752,37,87,0.425,10,28,0.357142857,0.75,27,59,0.457627119,Knicks,New York,240,12,16,11,35,46,22,8,5,14,25,96,-2
22000376,MIA,1610612748,26,70,0.371,14,33,0.424242424,0.821,12,37,0.324324324,Heat,Miami,240,32,39,6,32,38,21,5,6,10,14,98,2
22000377,NOP,1610612740,47,92,0.511,12,31,0.387096774,0.857,35,61,0.573770492,Pelicans,New Orleans,240,24,28,15,40,55,31,7,6,9,20,130,29
22000377,HOU,1610612745,38,91,0.418,13,43,0.302325581,0.571,25,48,0.520833333,Rockets,Houston,240,12,21,12,25,37,24,5,4,12,23,101,-29
22000378,SAS,1610612759,32,86,0.372,8,24,0.333333333,0.905,24,62,0.387096774,Spurs,San Antonio,240,19,21,8,37,45,20,2,5,14,16,91,-23
22000378,GSW,1610612744,42,91,0.462,17,40,0.425,0.684,25,51,0.490196078,Warriors,Golden State,240,13,19,10,40,50,26,8,4,10,19,114,23
22000379,UTA,1610612762,40,84,0.476,18,48,0.375,0.889,22,36,0.611111111,Jazz,Utah,240,24,27,10,31,41,28,4,7,10,22,122,14
22000379,BOS,1610612738,38,86,0.442,13,29,0.448275862,0.826,25,57,0.438596491,Celtics,Boston,240,19,23,11,24,35,18,2,2,8,25,108,-14
22000380,POR,1610612757,35,90,0.389,18,46,0.391304348,0.947,17,44,0.386363636,Trail Blazers,Portland,240,18,19,9,45,54,18,6,6,8,17,106,9
22000380,ORL,1610612753,37,88,0.42,11,35,0.314285714,0.545,26,53,0.490566038,Magic,Orlando,240,12,22,10,43,53,22,7,3,10,11,97,-9
22000381,SAC,1610612758,43,99,0.434,14,42,0.333333333,0.579,29,57,0.50877193,Kings,Sacramento,240,11,19,8,31,39,24,6,8,11,28,111,-8
22000381,PHI,1610612755,41,85,0.482,9,20,0.45,0.8,32,65,0.492307692,76ers,Philadelphia,240,28,35,12,47,59,24,4,5,17,22,119,8
22000382,WAS,1610612764,42,93,0.452,12,41,0.292682927,0.826,30,52,0.576923077,Wizards,Washington,240,19,23,12,34,46,26,7,3,14,20,115,-22
22000382,TOR,1610612761,49,93,0.527,19,32,0.59375,0.87,30,61,0.491803279,Raptors,Toronto,240,20,23,9,37,46,28,5,5,12,17,137,22
22000383,IND,1610612754,36,92,0.391,15,38,0.394736842,0.636,21,54,0.388888889,Pacers,Indiana,240,7,11,10,33,43,26,4,5,8,21,94,-10
22000383,BKN,1610612751,32,76,0.421,9,31,0.290322581,0.886,23,45,0.511111111,Nets,Brooklyn,240,31,35,9,37,46,20,2,5,12,20,104,10
22000384,DAL,1610612742,43,84,0.512,14,35,0.4,0.9,29,49,0.591836735,Mavericks,Dallas,240,18,20,4,33,37,25,3,3,9,24,118,1
22000384,ATL,1610612737,40,88,0.455,14,39,0.358974359,0.821,26,49,0.530612245,Hawks,Atlanta,240,23,28,9,33,42,27,7,4,9,20,117,-1
22000385,NOP,1610612740,41,81,0.506,13,36,0.361111111,0.808,28,45,0.622222222,Pelicans,New Orleans,240,21,26,9,26,35,27,11,1,12,12,116,-13
22000385,CHI,1610612741,48,81,0.593,25,47,0.531914894,0.727,23,34,0.676470588,Bulls,Chicago,240,8,11,7,28,35,36,4,6,16,20,129,13
22000386,MEM,1610612763,47,94,0.5,23,49,0.469387755,0.722,24,45,0.533333333,Grizzlies,Memphis,240,13,18,19,27,46,34,10,2,16,18,130,16
22000386,CHA,1610612766,45,82,0.549,14,29,0.482758621,0.833,31,53,0.58490566,Hornets,Charlotte,240,10,12,8,27,35,23,11,4,18,14,114,-16
22000387,MIN,1610612750,41,95,0.432,15,41,0.365853659,0.789,26,54,0.481481481,Timberwolves,Minnesota,240,15,19,16,27,43,29,8,8,15,24,112,-7
22000387,LAC,1610612746,41,82,0.5,12,23,0.52173913,0.862,29,59,0.491525424,Clippers,LA,240,25,29,11,37,48,23,9,4,15,20,119,7
22000388,DEN,1610612743,51,85,0.6,16,36,0.444444444,0.714,35,49,0.714285714,Nuggets,Denver,240,15,21,4,35,39,31,12,9,11,18,133,38
22000388,CLE,1610612739,36,94,0.383,8,37,0.216216216,0.75,28,57,0.49122807,Cavaliers,Cleveland,240,15,20,18,31,49,25,7,7,17,18,95,-38
22000389,PHX,1610612756,46,87,0.529,15,31,0.483870968,0.72,31,56,0.553571429,Suns,Phoenix,240,18,25,12,35,47,25,7,2,11,19,125,1
22000389,MIL,1610612749,43,85,0.506,16,37,0.432432432,0.733,27,48,0.5625,Bucks,Milwaukee,240,22,30,10,29,39,23,6,0,9,21,124,-1
22000390,OKC,1610612760,47,100,0.47,7,31,0.225806452,0.857,40,69,0.579710145,Thunder,Oklahoma City,265,12,14,7,39,46,32,11,4,13,23,113,-1
22000390,LAL,1610612747,42,89,0.472,10,35,0.285714286,0.833,32,54,0.592592593,Lakers,Los Angeles,265,20,24,6,37,43,22,6,6,16,15,114,1
22000391,IND,1610612754,44,86,0.512,14,31,0.451612903,0.9,30,55,0.545454545,Pacers,Indiana,240,9,10,10,31,41,26,10,5,7,18,111,16
22000391,DET,1610612765,38,85,0.447,5,28,0.178571429,0.737,33,57,0.578947368,Pistons,Detroit,240,14,19,15,28,43,21,5,5,11,13,95,-16
22000392,MIA,1610612748,34,79,0.43,15,42,0.357142857,0.9,19,37,0.513513514,Heat,Miami,240,18,20,8,41,49,24,6,3,20,21,101,7
22000392,HOU,1610612745,32,83,0.386,15,50,0.3,0.75,17,33,0.515151515,Rockets,Houston,240,15,20,8,34,42,24,7,1,13,20,94,-7
22000393,ORL,1610612753,38,97,0.392,15,33,0.454545455,0.778,23,64,0.359375,Magic,Orlando,240,14,18,13,36,49,19,7,6,15,17,105,-6
22000393,GSW,1610612744,41,88,0.466,20,50,0.4,0.75,21,38,0.552631579,Warriors,Golden State,240,9,12,9,37,46,29,6,6,17,20,111,6
22000394,POR,1610612757,40,93,0.43,17,38,0.447368421,0.913,23,55,0.418181818,Trail Blazers,Portland,240,21,23,15,32,47,15,5,2,8,21,118,4
22000394,PHI,1610612755,42,86,0.488,6,27,0.222222222,0.828,36,59,0.610169492,76ers,Philadelphia,240,24,29,11,35,46,20,6,5,9,20,114,-4
22000395,MIN,1610612750,45,99,0.455,16,41,0.390243902,0.571,29,58,0.5,Timberwolves,Minnesota,240,8,14,9,31,40,28,10,4,8,18,114,-6
22000395,CHA,1610612766,44,90,0.489,13,36,0.361111111,1,31,54,0.574074074,Hornets,Charlotte,240,19,19,12,43,55,20,4,3,20,17,120,6
22000396,WAS,1610612764,34,89,0.382,9,34,0.264705882,0.7,25,55,0.454545455,Wizards,Washington,240,14,20,9,37,46,20,5,5,14,18,91,-18
22000396,NYK,1610612752,44,98,0.449,6,24,0.25,0.682,38,74,0.513513514,Knicks,New York,240,15,22,15,50,65,22,11,4,11,22,109,18
22000397,SAS,1610612759,45,85,0.529,12,31,0.387096774,0.821,33,54,0.611111111,Spurs,San Antonio,240,23,28,8,38,46,27,6,6,13,25,125,11
22000397,ATL,1610612737,39,90,0.433,11,32,0.34375,0.758,28,58,0.482758621,Hawks,Atlanta,240,25,33,10,31,41,22,10,4,12,17,114,-11
22000398,TOR,1610612761,41,83,0.494,9,28,0.321428571,0.789,32,55,0.581818182,Raptors,Toronto,240,15,19,3,29,32,26,7,8,13,26,106,-14
22000398,BOS,1610612738,39,86,0.453,20,39,0.512820513,0.786,19,47,0.404255319,Celtics,Boston,240,22,28,14,35,49,30,8,6,18,22,120,14
22000399,NOP,1610612740,48,90,0.533,17,37,0.459459459,0.739,31,53,0.58490566,Pelicans,New Orleans,240,17,23,9,29,38,31,5,3,9,19,130,-13
22000399,DAL,1610612742,51,88,0.58,25,45,0.555555556,0.762,26,43,0.604651163,Mavericks,Dallas,240,16,21,5,32,37,30,4,2,6,22,143,13
22000400,LAC,1610612746,50,86,0.581,13,30,0.433333333,0.8,37,56,0.660714286,Clippers,LA,240,12,15,4,33,37,20,11,7,9,13,125,19
22000400,CHI,1610612741,40,85,0.471,12,32,0.375,0.933,28,53,0.528301887,Bulls,Chicago,240,14,15,8,33,41,23,4,3,13,16,106,-19
22000401,OKC,1610612760,36,90,0.4,10,32,0.3125,0.765,26,58,0.448275862,Thunder,Oklahoma City,240,13,17,12,38,50,26,8,3,12,19,95,-2
22000401,DEN,1610612743,40,87,0.46,10,40,0.25,0.7,30,47,0.638297872,Nuggets,Denver,240,7,10,7,34,41,24,6,6,13,14,97,2
22000402,UTA,1610612762,43,82,0.524,14,38,0.368421053,0.853,29,44,0.659090909,Jazz,Utah,240,29,34,7,39,46,22,4,5,17,22,129,14
22000402,MIL,1610612749,42,92,0.457,12,33,0.363636364,0.704,30,59,0.508474576,Bucks,Milwaukee,240,19,27,6,27,33,19,8,6,10,28,115,-14
22000403,MEM,1610612763,39,80,0.487,12,29,0.413793103,0.789,27,51,0.529411765,Grizzlies,Memphis,240,15,19,6,27,33,31,9,2,17,25,105,-10
22000403,LAL,1610612747,43,85,0.506,6,30,0.2,0.697,37,55,0.672727273,Lakers,Los Angeles,240,23,33,13,34,47,26,9,4,18,16,115,10
22000404,POR,1610612757,43,83,0.518,13,35,0.371428571,0.909,30,48,0.625,Trail Blazers,Portland,240,30,33,9,36,45,16,3,4,14,29,129,19
22000404,CLE,1610612739,38,87,0.437,8,23,0.347826087,0.703,30,64,0.46875,Cavaliers,Cleveland,240,26,37,10,31,41,20,6,3,11,21,110,-19
22000405,SAC,1610612758,43,83,0.518,12,33,0.363636364,0.737,31,50,0.62,Kings,Sacramento,240,14,19,8,34,42,33,8,1,18,18,112,-11
22000405,ORL,1610612753,46,91,0.505,15,34,0.441176471,0.8,31,57,0.543859649,Magic,Orlando,240,16,20,10,32,42,25,8,2,10,15,123,11
22000406,PHX,1610612756,48,79,0.608,10,25,0.4,0.824,38,54,0.703703704,Suns,Phoenix,240,14,17,4,28,32,25,8,3,13,24,120,9
22000406,PHI,1610612755,38,73,0.521,7,17,0.411764706,0.848,31,56,0.553571429,76ers,Philadelphia,240,28,33,8,27,35,19,7,1,13,15,111,-9
22000407,IND,1610612754,45,89,0.506,12,31,0.387096774,0.852,33,58,0.568965517,Pacers,Indiana,240,23,27,7,36,43,34,8,6,9,21,125,12
22000407,ATL,1610612737,43,90,0.478,9,31,0.290322581,0.783,34,59,0.576271186,Hawks,Atlanta,240,18,23,7,31,38,35,5,4,11,24,113,-12
22000408,NYK,1610612752,45,86,0.523,12,28,0.428571429,0.826,33,58,0.568965517,Knicks,New York,240,19,23,4,40,44,21,4,4,7,21,121,22
22000408,HOU,1610612745,33,88,0.375,8,43,0.186046512,0.833,25,45,0.555555556,Rockets,Houston,240,25,30,12,34,46,17,5,5,9,17,99,-22
22000409,GSW,1610612744,44,90,0.489,9,34,0.264705882,0.8,35,56,0.625,Warriors,Golden State,240,20,25,5,32,37,25,6,6,13,15,117,-17
22000409,BKN,1610612751,50,93,0.538,16,39,0.41025641,0.9,34,54,0.62962963,Nets,Brooklyn,240,18,20,8,37,45,35,9,5,13,15,134,17
22000410,UTA,1610612762,39,85,0.459,12,46,0.260869565,0.759,27,39,0.692307692,Jazz,Utah,240,22,29,10,38,48,26,11,7,15,21,112,18
22000410,MIA,1610612748,35,86,0.407,12,36,0.333333333,0.706,23,50,0.46,Heat,Miami,240,12,17,8,35,43,24,11,3,17,21,94,-18
22000411,POR,1610612757,45,85,0.529,18,40,0.45,0.684,27,45,0.6,Trail Blazers,Portland,240,13,19,10,26,36,15,7,2,15,23,121,3
22000411,DAL,1610612742,40,81,0.494,14,41,0.341463415,0.96,26,40,0.65,Mavericks,Dallas,240,24,25,10,25,35,19,5,6,12,21,118,-3
22000412,DET,1610612765,34,79,0.43,15,38,0.394736842,0.833,19,41,0.463414634,Pistons,Detroit,240,25,30,6,38,44,25,3,6,12,20,108,6
22000412,BOS,1610612738,36,82,0.439,8,27,0.296296296,0.733,28,55,0.509090909,Celtics,Boston,240,22,30,7,37,44,15,9,2,10,25,102,-6
22000413,TOR,1610612761,38,91,0.418,10,33,0.303030303,0.839,28,58,0.482758621,Raptors,Toronto,240,26,31,10,28,38,24,6,3,11,22,112,-4
22000413,MIN,1610612750,43,82,0.524,16,39,0.41025641,0.737,27,43,0.627906977,Timberwolves,Minnesota,240,14,19,5,35,40,28,6,8,18,26,116,4
22000414,SAS,1610612759,48,96,0.5,10,34,0.294117647,0.842,38,62,0.612903226,Spurs,San Antonio,240,16,19,10,33,43,31,13,4,9,13,122,12
22000414,CHA,1610612766,45,95,0.474,12,34,0.352941176,0.727,33,61,0.540983607,Hornets,Charlotte,240,8,11,12,37,49,23,6,6,16,20,110,-12
22000415,OKC,1610612760,45,95,0.474,15,36,0.416666667,0.563,30,59,0.508474576,Thunder,Oklahoma City,240,9,16,12,37,49,32,8,1,13,14,114,5
22000415,MIL,1610612749,45,97,0.464,13,38,0.342105263,0.667,32,59,0.542372881,Bucks,Milwaukee,240,6,9,12,35,47,24,9,5,14,16,109,-5
22000416,LAL,1610612747,40,87,0.46,6,28,0.214285714,0.655,34,59,0.576271186,Lakers,Los Angeles,240,19,29,8,38,46,27,4,4,10,26,105,-17
22000416,DEN,1610612743,39,85,0.459,19,47,0.404255319,0.735,20,38,0.526315789,Nuggets,Denver,240,25,34,9,38,47,28,6,4,9,24,122,17
22000417,PHX,1610612756,41,92,0.446,12,37,0.324324324,0.938,29,55,0.527272727,Suns,Phoenix,240,15,16,11,48,59,24,6,2,8,17,109,19
22000417,ORL,1610612753,33,89,0.371,6,35,0.171428571,0.818,27,54,0.5,Magic,Orlando,240,18,22,9,39,48,13,4,6,10,12,90,-19
22000418,SAC,1610612758,41,82,0.5,8,33,0.242424242,0.769,33,49,0.673469388,Kings,Sacramento,240,20,26,5,28,33,22,8,5,16,19,110,-14
22000418,MEM,1610612763,50,94,0.532,9,21,0.428571429,0.789,41,73,0.561643836,Grizzlies,Memphis,240,15,19,9,34,43,31,10,2,10,20,124,14
22000419,LAC,1610612746,42,88,0.477,13,30,0.433333333,0.861,29,58,0.5,Clippers,LA,240,31,36,12,35,47,31,8,5,10,21,128,17
22000419,CLE,1610612739,43,93,0.462,7,25,0.28,0.72,36,68,0.529411765,Cavaliers,Cleveland,240,18,25,11,29,40,25,4,4,15,27,111,-17
22000420,IND,1610612754,39,92,0.424,9,33,0.272727273,0.806,30,59,0.508474576,Pacers,Indiana,265,25,31,8,39,47,18,9,14,19,23,112,-8
22000420,CHI,1610612741,44,102,0.431,13,33,0.393939394,0.864,31,69,0.449275362,Bulls,Chicago,265,19,22,13,47,60,25,6,2,18,24,120,8
22000421,WAS,1610612764,48,92,0.522,12,30,0.4,0.742,36,62,0.580645161,Wizards,Washington,240,23,31,10,37,47,25,14,2,15,24,131,12
22000421,HOU,1610612745,43,91,0.473,8,37,0.216216216,0.735,35,54,0.648148148,Rockets,Houston,240,25,34,9,32,41,23,9,5,18,22,119,-12
22000422,NYK,1610612752,42,83,0.506,17,34,0.5,0.815,25,49,0.510204082,Knicks,New York,240,22,27,10,32,42,22,5,6,8,22,123,11
22000422,ATL,1610612737,36,85,0.424,11,33,0.333333333,0.906,25,52,0.480769231,Hawks,Atlanta,240,29,32,11,31,42,17,5,6,11,19,112,-11
22000423,UTA,1610612762,45,86,0.523,18,45,0.4,0.839,27,41,0.658536585,Jazz,Utah,240,26,31,7,29,36,18,9,4,11,18,134,11
22000423,PHI,1610612755,47,94,0.5,8,23,0.347826087,0.875,39,71,0.549295775,76ers,Philadelphia,240,21,24,12,30,42,19,6,4,12,21,123,-11
22000424,GSW,1610612744,46,88,0.523,17,37,0.459459459,0.952,29,51,0.568627451,Warriors,Golden State,240,20,21,5,34,39,34,9,10,14,23,129,31
22000424,CLE,1610612739,37,95,0.389,8,30,0.266666667,0.8,29,65,0.446153846,Cavaliers,Cleveland,240,16,20,15,34,49,19,10,3,17,24,98,-31
22000425,MIA,1610612748,46,91,0.505,8,36,0.222222222,0.818,38,55,0.690909091,Heat,Miami,240,18,22,9,30,39,27,7,6,8,21,118,-7
22000425,LAC,1610612746,47,85,0.553,15,32,0.46875,0.8,32,53,0.603773585,Clippers,LA,240,16,20,7,32,39,31,5,0,12,22,125,7
22000426,SAC,1610612758,51,96,0.531,12,33,0.363636364,0.846,39,63,0.619047619,Kings,Sacramento,240,11,13,15,26,41,24,6,6,13,13,125,-11
22000426,BKN,1610612751,51,89,0.573,27,47,0.574468085,0.583,24,42,0.571428571,Nets,Brooklyn,240,7,12,9,26,35,31,7,4,15,16,136,11
22000427,DEN,1610612743,38,84,0.452,9,34,0.264705882,0.933,29,50,0.58,Nuggets,Denver,240,14,15,11,27,38,25,12,3,17,18,99,-13
22000427,BOS,1610612738,39,81,0.481,15,42,0.357142857,0.905,24,39,0.615384615,Celtics,Boston,240,19,21,10,33,43,26,7,1,20,22,112,13
22000428,SAS,1610612759,47,83,0.566,12,25,0.48,0.6,35,58,0.603448276,Spurs,San Antonio,240,3,5,10,35,45,29,3,9,21,23,109,10
22000428,DET,1610612765,39,83,0.47,7,25,0.28,0.56,32,58,0.551724138,Pistons,Detroit,240,14,25,8,26,34,22,9,5,8,9,99,-10
22000429,NOP,1610612740,56,91,0.615,19,38,0.5,0.765,37,53,0.698113208,Pelicans,New Orleans,240,13,17,11,36,47,33,14,4,19,19,144,31
22000429,MEM,1610612763,42,88,0.477,13,31,0.419354839,0.889,29,57,0.50877193,Grizzlies,Memphis,240,16,18,9,23,32,23,10,0,19,18,113,-31
22000430,TOR,1610612761,46,91,0.505,17,43,0.395348837,0.714,29,48,0.604166667,Raptors,Toronto,240,15,21,8,36,44,25,8,6,15,18,124,11
22000430,MIL,1610612749,40,83,0.482,14,37,0.378378378,0.76,26,46,0.565217391,Bucks,Milwaukee,240,19,25,5,36,41,25,10,5,17,17,113,-11
22000431,MIN,1610612750,39,93,0.419,16,34,0.470588235,0.769,23,59,0.389830508,Timberwolves,Minnesota,240,10,13,11,27,38,26,11,4,15,27,104,-8
22000431,LAL,1610612747,42,77,0.545,11,26,0.423076923,0.81,31,51,0.607843137,Lakers,Los Angeles,240,17,21,6,32,38,20,8,8,18,14,112,8
22000432,POR,1610612757,42,96,0.438,20,47,0.425531915,0.647,22,49,0.448979592,Trail Blazers,Portland,240,11,17,15,39,54,26,6,8,10,23,115,11
22000432,OKC,1610612760,37,85,0.435,10,33,0.303030303,0.741,27,52,0.519230769,Thunder,Oklahoma City,240,20,27,7,39,46,23,6,3,11,16,104,-11
22000433,PHX,1610612756,48,88,0.545,16,37,0.432432432,1,32,51,0.62745098,Suns,Phoenix,240,12,12,4,30,34,28,7,3,6,15,124,-4
22000433,BKN,1610612751,47,82,0.573,20,40,0.5,0.933,27,42,0.642857143,Nets,Brooklyn,240,14,15,4,33,37,28,4,4,10,11,128,4
22000434,CHI,1610612741,46,91,0.505,18,37,0.486486486,0.588,28,54,0.518518519,Bulls,Chicago,240,10,17,15,41,56,33,10,8,17,20,120,21
22000434,CHA,1610612766,38,90,0.422,16,35,0.457142857,0.389,22,55,0.4,Hornets,Charlotte,240,7,18,13,32,45,29,11,3,15,16,99,-21
22000435,SAS,1610612759,41,88,0.466,7,18,0.388888889,0.818,34,70,0.485714286,Spurs,San Antonio,240,27,33,17,34,51,19,5,4,13,25,116,6
22000435,CLE,1610612739,39,89,0.438,7,27,0.259259259,0.781,32,62,0.516129032,Cavaliers,Cleveland,240,25,32,15,32,47,19,8,4,10,21,110,-6
22000436,ORL,1610612753,42,92,0.457,16,34,0.470588235,0.7,26,58,0.448275862,Magic,Orlando,240,7,10,10,40,50,27,10,7,12,15,107,18
22000436,NYK,1610612752,33,87,0.379,7,27,0.259259259,0.842,26,60,0.433333333,Knicks,New York,240,16,19,10,36,46,16,7,5,16,14,89,-18
22000437,WAS,1610612764,44,86,0.512,15,33,0.454545455,0.794,29,53,0.547169811,Wizards,Washington,240,27,34,9,36,45,31,7,3,13,20,130,2
22000437,DEN,1610612743,48,92,0.522,17,38,0.447368421,0.833,31,54,0.574074074,Nuggets,Denver,240,15,18,10,32,42,23,7,7,11,26,128,-2
22000438,BOS,1610612738,40,86,0.465,10,31,0.322580645,0.889,30,55,0.545454545,Celtics,Boston,240,24,27,11,26,37,22,9,3,16,27,114,-8
22000438,ATL,1610612737,44,77,0.571,8,24,0.333333333,0.839,36,53,0.679245283,Hawks,Atlanta,240,26,31,8,29,37,19,8,2,14,18,122,8
22000439,PHI,1610612755,39,81,0.481,12,26,0.461538462,0.875,27,55,0.490909091,76ers,Philadelphia,240,28,32,7,40,47,23,12,6,20,21,118,5
22000439,HOU,1610612745,42,92,0.457,15,47,0.319148936,0.778,27,45,0.6,Rockets,Houston,240,14,18,9,30,39,26,13,6,18,24,113,-5
22000440,MIN,1610612750,45,107,0.421,15,40,0.375,0.92,30,67,0.447761194,Timberwolves,Minnesota,265,23,25,11,33,44,37,12,8,11,20,128,-6
22000440,IND,1610612754,49,97,0.505,13,26,0.5,0.852,36,71,0.507042254,Pacers,Indiana,265,23,27,10,41,51,31,5,7,14,18,134,6
22000441,POR,1610612757,46,90,0.511,18,41,0.43902439,0.889,28,49,0.571428571,Trail Blazers,Portland,240,16,18,7,24,31,26,6,7,9,19,126,2
22000441,NOP,1610612740,43,89,0.483,15,32,0.46875,0.793,28,57,0.49122807,Pelicans,New Orleans,240,23,29,18,33,51,25,5,1,11,15,124,-2
22000442,DET,1610612765,40,79,0.506,13,32,0.40625,0.774,27,47,0.574468085,Pistons,Detroit,240,24,31,7,35,42,30,2,2,13,24,117,-10
22000442,DAL,1610612742,46,92,0.5,16,43,0.372093023,0.731,30,49,0.612244898,Mavericks,Dallas,240,19,26,11,32,43,25,8,2,6,22,127,10
22000443,MIA,1610612748,44,97,0.454,13,36,0.361111111,0.917,31,61,0.508196721,Heat,Miami,265,11,12,7,42,49,28,8,5,15,22,112,-8
22000443,GSW,1610612744,43,95,0.453,18,52,0.346153846,0.762,25,43,0.581395349,Warriors,Golden State,265,16,21,9,37,46,32,10,1,16,19,120,8
22000444,UTA,1610612762,42,98,0.429,13,40,0.325,0.85,29,58,0.5,Jazz,Utah,240,17,20,17,36,53,19,12,3,13,15,114,18
22000444,LAC,1610612746,38,86,0.442,9,26,0.346153846,0.647,29,60,0.483333333,Clippers,LA,240,11,17,9,38,47,18,5,2,16,19,96,-18
22000445,TOR,1610612761,38,78,0.487,12,35,0.342857143,0.957,26,43,0.604651163,Raptors,Toronto,240,22,23,2,35,37,26,6,6,9,21,110,14
22000445,MIL,1610612749,35,88,0.398,10,34,0.294117647,0.696,25,54,0.462962963,Bucks,Milwaukee,240,16,23,15,37,52,23,6,2,15,23,96,-14
22000446,LAL,1610612747,40,83,0.482,8,30,0.266666667,0.714,32,53,0.603773585,Lakers,Los Angeles,240,10,14,10,29,39,21,7,4,16,16,98,-11
22000446,BKN,1610612751,38,77,0.494,18,39,0.461538462,0.625,20,38,0.526315789,Nets,Brooklyn,240,15,24,8,31,39,23,9,3,13,18,109,11
22000447,SAC,1610612758,43,93,0.462,15,41,0.365853659,0.563,28,52,0.538461538,Kings,Sacramento,240,9,16,13,31,44,29,7,3,15,18,110,-8
22000447,MIA,1610612748,49,95,0.516,12,34,0.352941176,0.8,37,61,0.606557377,Heat,Miami,240,8,10,8,37,45,36,8,2,14,15,118,8
22000448,DEN,1610612743,41,83,0.494,13,33,0.393939394,0.846,28,50,0.56,Nuggets,Denver,240,22,26,10,28,38,26,12,2,17,19,117,5
22000448,CHA,1610612766,42,91,0.462,11,39,0.282051282,0.85,31,52,0.596153846,Hornets,Charlotte,240,17,20,15,34,49,30,9,5,17,17,112,-5
22000449,ORL,1610612753,46,94,0.489,18,43,0.418604651,0.824,28,51,0.549019608,Magic,Orlando,240,14,17,8,43,51,30,7,8,13,19,124,4
22000449,GSW,1610612744,46,97,0.474,19,42,0.452380952,0.6,27,55,0.490909091,Warriors,Golden State,240,9,15,9,36,45,37,8,0,13,19,120,-4
22000450,PHI,1610612755,41,87,0.471,7,21,0.333333333,0.793,34,66,0.515151515,76ers,Philadelphia,240,23,29,16,37,53,23,5,7,15,18,112,7
22000450,CHI,1610612741,40,95,0.421,7,32,0.21875,1,33,63,0.523809524,Bulls,Chicago,240,18,18,13,29,42,24,5,6,11,20,105,-7
22000451,BOS,1610612738,50,90,0.556,14,35,0.4,0.7,36,55,0.654545455,Celtics,Boston,240,7,10,9,35,44,26,8,12,18,21,121,12
22000451,ATL,1610612737,38,90,0.422,10,30,0.333333333,0.92,28,60,0.466666667,Hawks,Atlanta,240,23,25,13,28,41,21,14,6,13,14,109,-12
22000452,MEM,1610612763,42,90,0.467,5,20,0.25,0.87,37,70,0.528571429,Grizzlies,Memphis,240,20,23,13,36,49,20,12,4,11,13,109,14
22000452,DET,1610612765,36,86,0.419,14,45,0.311111111,0.692,22,41,0.536585366,Pistons,Detroit,240,9,13,13,32,45,27,8,7,21,22,95,-14
22000453,OKC,1610612760,31,85,0.365,12,40,0.3,0.524,19,45,0.422222222,Thunder,Oklahoma City,240,11,21,8,38,46,20,4,5,10,23,85,-13
22000453,MIL,1610612749,35,86,0.407,11,34,0.323529412,0.68,24,52,0.461538462,Bucks,Milwaukee,240,17,25,11,50,61,23,5,6,12,18,98,13
22000454,TOR,1610612761,28,85,0.329,12,40,0.3,0.818,16,45,0.355555556,Raptors,Toronto,240,18,22,15,36,51,16,8,6,15,16,86,5
22000454,MIN,1610612750,32,83,0.386,9,38,0.236842105,0.727,23,45,0.511111111,Timberwolves,Minnesota,240,8,11,6,37,43,24,6,9,13,23,81,-5
22000455,PHX,1610612756,51,88,0.58,22,39,0.564102564,0.667,29,49,0.591836735,Suns,Phoenix,240,8,12,4,33,37,38,8,4,13,17,132,18
22000455,NOP,1610612740,42,82,0.512,11,32,0.34375,0.792,31,50,0.62,Pelicans,New Orleans,240,19,24,6,31,37,28,11,3,13,16,114,-18
22000456,HOU,1610612745,38,88,0.432,17,44,0.386363636,0.563,21,44,0.477272727,Rockets,Houston,240,9,16,10,39,49,21,7,5,10,18,102,9
22000456,DAL,1610612742,33,87,0.379,10,39,0.256410256,0.773,23,48,0.479166667,Mavericks,Dallas,240,17,22,11,35,46,16,4,5,9,15,93,-9
22000457,UTA,1610612762,41,86,0.477,12,34,0.352941176,0.857,29,52,0.557692308,Jazz,Utah,240,18,21,6,32,38,13,7,6,10,22,112,-4
22000457,LAC,1610612746,43,89,0.483,10,30,0.333333333,0.909,33,59,0.559322034,Clippers,LA,240,20,22,11,34,45,22,5,4,11,20,116,4
22000458,SAS,1610612759,38,91,0.418,6,21,0.285714286,0.842,32,70,0.457142857,Spurs,San Antonio,240,16,19,9,38,47,22,4,6,9,16,98,-4
22000458,NYK,1610612752,35,86,0.407,14,35,0.4,1,21,51,0.411764706,Knicks,New York,240,18,18,10,38,48,23,7,8,10,19,102,4
22000459,GSW,1610612744,37,85,0.435,13,39,0.333333333,0.765,24,46,0.52173913,Warriors,Golden State,240,13,17,9,30,39,23,10,3,14,12,100,-2
22000459,CHA,1610612766,37,75,0.493,20,40,0.5,0.889,17,35,0.485714286,Hornets,Charlotte,240,8,9,4,40,44,23,7,2,24,22,102,2
22000460,SAC,1610612758,44,98,0.449,8,29,0.275862069,0.818,36,69,0.52173913,Kings,Sacramento,240,18,22,12,29,41,22,8,3,7,18,114,-8
22000460,CHI,1610612741,49,82,0.598,11,23,0.47826087,0.867,38,59,0.644067797,Bulls,Chicago,240,13,15,2,36,38,24,5,8,14,23,122,8
22000461,IND,1610612754,50,94,0.532,15,36,0.416666667,0.773,35,58,0.603448276,Pacers,Indiana,240,17,22,11,37,48,28,10,6,18,16,132,8
22000461,HOU,1610612745,48,104,0.462,10,34,0.294117647,0.818,38,70,0.542857143,Rockets,Houston,240,18,22,16,31,47,22,12,6,15,17,124,-8
22000462,PHX,1610612756,46,86,0.535,24,46,0.52173913,0.923,22,40,0.55,Suns,Phoenix,240,12,13,5,36,41,35,5,7,10,14,128,31
22000462,MEM,1610612763,36,93,0.387,5,33,0.151515152,0.87,31,60,0.516666667,Grizzlies,Memphis,240,20,23,17,32,49,19,5,4,12,12,97,-31
22000463,MIA,1610612748,36,85,0.424,8,28,0.285714286,0.696,28,57,0.49122807,Heat,Miami,240,16,23,10,39,49,24,8,3,14,20,96,2
22000463,LAL,1610612747,33,84,0.393,13,45,0.288888889,0.882,20,39,0.512820513,Lakers,Los Angeles,240,15,17,6,37,43,25,5,6,14,17,94,-2
22000464,WAS,1610612764,45,89,0.506,6,26,0.230769231,0.759,39,63,0.619047619,Wizards,Washington,240,22,29,12,42,54,23,8,3,17,19,118,7
22000464,POR,1610612757,37,103,0.359,19,55,0.345454545,0.72,18,48,0.375,Trail Blazers,Portland,240,18,25,17,33,50,19,10,7,12,22,111,-7
22000465,NOP,1610612740,42,94,0.447,11,36,0.305555556,0.676,31,58,0.534482759,Pelicans,New Orleans,265,25,37,12,40,52,22,5,7,13,24,120,5
22000465,BOS,1610612738,39,98,0.398,10,37,0.27027027,0.794,29,61,0.475409836,Celtics,Boston,265,27,34,11,38,49,22,9,11,10,30,115,-5
22000466,OKC,1610612760,43,79,0.544,13,28,0.464285714,0.75,30,51,0.588235294,Thunder,Oklahoma City,240,18,24,5,32,37,22,9,3,14,18,117,16
22000466,CLE,1610612739,39,84,0.464,8,35,0.228571429,0.75,31,49,0.632653061,Cavaliers,Cleveland,240,15,20,14,28,42,22,9,4,15,17,101,-16
22000467,ORL,1610612753,35,81,0.432,9,30,0.3,0.897,26,51,0.509803922,Magic,Orlando,240,26,29,5,46,51,24,7,8,11,18,105,9
22000467,DET,1610612765,34,91,0.374,11,40,0.275,0.81,23,51,0.450980392,Pistons,Detroit,240,17,21,9,40,49,23,10,4,11,21,96,-9
22000468,TOR,1610612761,40,81,0.494,14,34,0.411764706,0.889,26,47,0.553191489,Raptors,Toronto,240,16,18,5,34,39,25,5,5,14,24,110,7
22000468,PHI,1610612755,33,85,0.388,11,37,0.297297297,0.743,22,48,0.458333333,76ers,Philadelphia,240,26,35,11,34,45,26,8,7,10,21,103,-7
22000469,NYK,1610612752,33,78,0.423,6,18,0.333333333,0.816,27,60,0.45,Knicks,New York,240,31,38,11,37,48,17,4,4,13,25,103,4
22000469,MIN,1610612750,33,82,0.402,16,35,0.457142857,0.81,17,47,0.361702128,Timberwolves,Minnesota,240,17,21,7,36,43,24,6,3,15,24,99,-4
22000470,DEN,1610612743,43,84,0.512,16,36,0.444444444,0.813,27,48,0.5625,Nuggets,Denver,240,13,16,3,30,33,25,8,3,13,24,115,-8
22000470,ATL,1610612737,42,81,0.519,12,34,0.352941176,0.818,30,47,0.638297872,Hawks,Atlanta,240,27,33,10,34,44,29,6,4,11,20,123,8
22000471,SAC,1610612758,44,100,0.44,12,33,0.363636364,0.75,32,67,0.47761194,Kings,Sacramento,240,15,20,14,29,43,29,6,3,12,26,115,-13
22000471,MIL,1610612749,44,90,0.489,11,28,0.392857143,0.806,33,62,0.532258065,Bucks,Milwaukee,240,29,36,14,42,56,22,8,5,17,19,128,13
22000472,LAC,1610612746,40,87,0.46,15,35,0.428571429,0.722,25,52,0.480769231,Clippers,LA,240,13,18,16,36,52,24,3,4,16,17,108,-4
22000472,BKN,1610612751,44,92,0.478,11,38,0.289473684,0.684,33,54,0.611111111,Nets,Brooklyn,240,13,19,9,31,40,21,10,4,6,19,112,4
22000473,SAS,1610612759,36,84,0.429,8,28,0.285714286,0.829,28,56,0.5,Spurs,San Antonio,240,29,35,9,48,57,27,4,4,12,23,109,15
22000473,IND,1610612754,34,104,0.327,8,34,0.235294118,0.667,26,70,0.371428571,Pacers,Indiana,240,18,27,14,40,54,20,4,7,7,27,94,-15
22000474,HOU,1610612745,37,96,0.385,13,40,0.325,0.684,24,56,0.428571429,Rockets,Houston,240,13,19,11,35,46,20,7,4,9,16,100,-20
22000474,CHI,1610612741,49,91,0.538,15,36,0.416666667,0.7,34,55,0.618181818,Bulls,Chicago,240,7,10,8,47,55,24,5,5,11,17,120,20
22000475,OKC,1610612760,32,74,0.432,14,39,0.358974359,0.842,18,35,0.514285714,Thunder,Oklahoma City,240,16,19,5,33,38,20,6,1,17,24,94,-14
22000475,MIA,1610612748,36,81,0.444,15,40,0.375,0.84,21,41,0.512195122,Heat,Miami,240,21,25,10,35,45,30,7,6,13,20,108,14
22000476,MEM,1610612763,37,94,0.394,6,31,0.193548387,0.632,31,63,0.492063492,Grizzlies,Memphis,240,12,19,13,38,51,17,7,1,13,23,92,-10
22000476,DAL,1610612742,35,80,0.438,15,41,0.365853659,0.654,20,39,0.512820513,Mavericks,Dallas,240,17,26,5,44,49,17,6,4,16,18,102,10
22000477,POR,1610612757,37,84,0.44,12,39,0.307692308,0.737,25,45,0.555555556,Trail Blazers,Portland,240,14,19,13,33,46,15,6,6,16,17,100,-32
22000477,PHX,1610612756,50,99,0.505,16,33,0.484848485,0.889,34,66,0.515151515,Suns,Phoenix,240,16,18,13,30,43,29,6,5,7,13,132,32
22000478,UTA,1610612762,45,85,0.529,28,55,0.509090909,0.824,17,30,0.566666667,Jazz,Utah,240,14,17,8,37,45,34,7,7,22,19,132,22
22000478,CHA,1610612766,41,89,0.461,11,36,0.305555556,0.81,30,53,0.566037736,Hornets,Charlotte,240,17,21,8,27,35,18,13,2,16,17,110,-22
22000479,WAS,1610612764,47,96,0.49,9,25,0.36,0.727,38,71,0.535211268,Wizards,Washington,265,24,33,5,44,49,25,9,4,16,25,127,3
22000479,LAL,1610612747,49,104,0.471,15,44,0.340909091,0.647,34,60,0.566666667,Lakers,Los Angeles,265,11,17,12,33,45,29,9,11,20,29,124,-3
22000480,CLE,1610612739,41,78,0.526,15,28,0.535714286,0.789,26,50,0.52,Cavaliers,Cleveland,240,15,19,7,29,36,28,7,10,15,19,112,1
22000480,ATL,1610612737,40,89,0.449,14,31,0.451612903,0.739,26,58,0.448275862,Hawks,Atlanta,240,17,23,13,28,41,22,10,4,11,19,111,-1
22000481,ORL,1610612753,33,88,0.375,14,38,0.368421053,0.591,19,50,0.38,Magic,Orlando,240,13,22,10,38,48,25,9,6,12,16,93,-12
22000481,DET,1610612765,41,88,0.466,10,34,0.294117647,0.813,31,54,0.574074074,Pistons,Detroit,240,13,16,8,41,49,24,10,9,15,19,105,12
22000482,SAC,1610612758,45,87,0.517,15,31,0.483870968,0.684,30,56,0.535714286,Kings,Sacramento,240,13,19,5,33,38,25,6,7,15,17,118,-9
22000482,BKN,1610612751,44,89,0.494,17,40,0.425,0.71,27,49,0.551020408,Nets,Brooklyn,240,22,31,10,31,41,30,8,5,8,16,127,9
22000483,NYK,1610612752,38,97,0.392,11,29,0.379310345,0.864,27,68,0.397058824,Knicks,New York,240,19,22,18,38,56,22,4,5,13,23,106,-8
22000483,GSW,1610612744,40,89,0.449,13,38,0.342105263,0.875,27,51,0.529411765,Warriors,Golden State,240,21,24,7,34,41,30,9,8,10,18,114,8
22000484,TOR,1610612761,40,93,0.43,11,37,0.297297297,0.846,29,56,0.517857143,Raptors,Toronto,240,11,13,8,30,38,29,12,11,10,20,102,-7
22000484,PHI,1610612755,33,80,0.412,17,38,0.447368421,0.867,16,42,0.380952381,76ers,Philadelphia,240,26,30,12,42,54,24,5,8,18,15,109,7
22000485,DAL,1610612742,42,89,0.472,13,33,0.393939394,0.867,29,56,0.517857143,Mavericks,Dallas,240,13,15,8,30,38,19,5,1,9,17,110,3
22000485,BOS,1610612738,41,86,0.477,12,39,0.307692308,0.722,29,47,0.617021277,Celtics,Boston,240,13,18,12,34,46,19,6,6,13,21,107,-3
22000486,MIN,1610612750,42,98,0.429,19,54,0.351851852,1,23,44,0.522727273,Timberwolves,Minnesota,240,9,9,7,36,43,35,4,5,14,16,112,-27
22000486,MIL,1610612749,53,99,0.535,20,42,0.476190476,0.722,33,57,0.578947368,Bucks,Milwaukee,240,13,18,9,43,52,33,11,5,8,13,139,27
22000487,POR,1610612757,41,87,0.471,14,41,0.341463415,1,27,46,0.586956522,Trail Blazers,Portland,240,10,10,7,40,47,21,0,7,9,19,106,-5
22000487,DEN,1610612743,40,94,0.426,14,36,0.388888889,0.944,26,58,0.448275862,Nuggets,Denver,240,17,18,10,30,40,25,8,3,1,10,111,5
22000488,WAS,1610612764,47,88,0.534,11,20,0.55,0.688,36,68,0.529411765,Wizards,Washington,240,11,16,6,30,36,32,5,1,13,16,116,-19
22000488,LAC,1610612746,54,94,0.574,19,38,0.5,0.615,35,56,0.625,Clippers,LA,240,8,13,7,39,46,26,7,5,10,22,135,19
22000489,IND,1610612754,37,81,0.457,7,29,0.24137931,0.813,30,52,0.576923077,Pacers,Indiana,240,26,32,7,32,39,20,11,6,19,22,107,-4
22000489,GSW,1610612744,39,83,0.47,5,26,0.192307692,0.903,34,57,0.596491228,Warriors,Golden State,240,28,31,8,33,41,27,10,4,18,25,111,4
22000490,BOS,1610612738,42,95,0.442,8,31,0.258064516,0.87,34,64,0.53125,Celtics,Boston,240,20,23,12,24,36,20,10,6,6,16,112,-15
22000490,ATL,1610612737,45,85,0.529,23,42,0.547619048,0.824,22,43,0.511627907,Hawks,Atlanta,240,14,17,12,33,45,27,4,5,17,23,127,15
22000491,HOU,1610612745,36,90,0.4,10,33,0.303030303,0.824,26,57,0.456140351,Rockets,Houston,240,14,17,9,24,33,18,8,8,7,15,96,-16
22000491,CLE,1610612739,43,85,0.506,16,36,0.444444444,0.667,27,49,0.551020408,Cavaliers,Cleveland,240,10,15,11,44,55,24,4,10,16,20,112,16
22000492,TOR,1610612761,37,74,0.5,20,44,0.454545455,0.824,17,30,0.566666667,Raptors,Toronto,240,14,17,3,29,32,30,5,3,14,25,108,-8
22000492,MIA,1610612748,37,80,0.463,17,38,0.447368421,0.862,20,42,0.476190476,Heat,Miami,240,25,29,11,31,42,31,6,4,11,21,116,8
22000493,MIN,1610612750,47,104,0.452,12,38,0.315789474,0.952,35,66,0.53030303,Timberwolves,Minnesota,265,20,21,13,28,41,28,11,4,17,24,126,-7
22000493,CHI,1610612741,55,93,0.591,10,25,0.4,0.813,45,68,0.661764706,Bulls,Chicago,265,13,16,7,36,43,28,11,5,21,15,133,7
22000494,NOP,1610612740,50,90,0.556,10,23,0.434782609,0.621,40,67,0.597014925,Pelicans,New Orleans,240,18,29,12,33,45,31,10,6,12,10,128,10
22000494,DET,1610612765,47,89,0.528,13,36,0.361111111,0.688,34,53,0.641509434,Pistons,Detroit,240,11,16,9,29,38,31,8,6,13,23,118,-10
22000495,SAS,1610612759,40,86,0.465,9,25,0.36,0.667,31,61,0.508196721,Spurs,San Antonio,240,10,15,6,38,44,20,10,4,12,13,99,-3
22000495,OKC,1610612760,37,89,0.416,18,44,0.409090909,0.909,19,45,0.422222222,Thunder,Oklahoma City,240,10,11,10,42,52,21,6,4,17,14,102,3
22000496,PHX,1610612756,44,87,0.506,14,38,0.368421053,0.704,30,49,0.612244898,Suns,Phoenix,240,19,27,7,34,41,26,9,6,14,25,121,-3
22000496,CHA,1610612766,43,88,0.489,13,36,0.361111111,0.926,30,52,0.576923077,Hornets,Charlotte,240,25,27,9,37,46,24,8,5,13,21,124,3
22000497,UTA,1610612762,41,87,0.471,22,48,0.458333333,0.667,19,39,0.487179487,Jazz,Utah,240,10,15,14,39,53,28,7,1,12,16,114,25
22000497,LAL,1610612747,34,85,0.4,8,33,0.242424242,0.65,26,52,0.5,Lakers,Los Angeles,240,13,20,12,33,45,17,5,4,14,15,89,-25
22000498,PHI,1610612755,39,90,0.433,12,29,0.413793103,0.84,27,61,0.442622951,76ers,Philadelphia,240,21,25,8,31,39,26,11,6,7,19,111,14
22000498,DAL,1610612742,32,78,0.41,13,34,0.382352941,0.87,19,44,0.431818182,Mavericks,Dallas,240,20,23,10,40,50,17,2,9,18,21,97,-14
22000499,ORL,1610612753,35,87,0.402,9,36,0.25,0.867,26,51,0.509803922,Magic,Orlando,240,13,15,4,31,35,19,8,1,18,10,92,-37
22000499,BKN,1610612751,49,92,0.533,20,45,0.444444444,0.786,29,47,0.617021277,Nets,Brooklyn,240,11,14,7,44,51,30,11,2,13,18,129,37
22000500,SAC,1610612758,42,85,0.494,12,35,0.342857143,0.758,30,50,0.6,Kings,Sacramento,240,25,33,8,26,34,25,12,0,16,22,121,-19
22000500,NYK,1610612752,51,87,0.586,19,36,0.527777778,0.905,32,51,0.62745098,Knicks,New York,240,19,21,9,34,43,24,8,2,16,23,140,19
22000501,MEM,1610612763,50,92,0.543,11,19,0.578947368,0.688,39,73,0.534246575,Grizzlies,Memphis,240,11,16,7,41,48,27,7,1,6,17,122,28
22000501,LAC,1610612746,34,84,0.405,12,34,0.352941176,0.875,22,50,0.44,Clippers,LA,240,14,16,8,33,41,19,4,4,14,15,94,-28
22000502,WAS,1610612764,41,86,0.477,8,26,0.307692308,0.88,33,60,0.55,Wizards,Washington,240,22,25,10,32,42,24,9,2,11,20,112,2
22000502,DEN,1610612743,37,85,0.435,15,38,0.394736842,0.875,22,47,0.468085106,Nuggets,Denver,240,21,24,12,32,44,23,6,7,18,20,110,-2
22000503,NOP,1610612740,51,102,0.5,13,39,0.333333333,0.714,38,63,0.603174603,Pelicans,New Orleans,240,10,14,12,35,47,32,5,4,9,17,125,-4
22000503,MIL,1610612749,52,96,0.542,13,31,0.419354839,0.75,39,65,0.6,Bucks,Milwaukee,240,12,16,8,34,42,21,4,8,9,13,129,4
22000504,SAC,1610612758,37,89,0.416,7,32,0.21875,0.707,30,57,0.526315789,Kings,Sacramento,240,29,41,14,35,49,24,5,6,10,25,110,3
22000504,DET,1610612765,37,82,0.451,12,33,0.363636364,0.656,25,49,0.510204082,Pistons,Detroit,240,21,32,10,35,45,20,6,6,11,25,107,-3
22000505,IND,1610612754,35,89,0.393,15,46,0.326086957,0.931,20,43,0.465116279,Pacers,Indiana,240,27,29,8,32,40,26,8,6,8,22,112,-6
22000505,BOS,1610612738,42,82,0.512,9,22,0.409090909,0.862,33,60,0.55,Celtics,Boston,240,25,29,7,38,45,24,3,6,11,20,118,6
22000506,TOR,1610612761,40,89,0.449,16,41,0.390243902,0.963,24,48,0.5,Raptors,Toronto,240,26,27,11,37,48,29,6,8,12,20,122,11
22000506,HOU,1610612745,39,91,0.429,16,47,0.340425532,0.85,23,44,0.522727273,Rockets,Houston,240,17,20,7,30,37,23,4,5,11,24,111,-11
22000507,UTA,1610612762,40,94,0.426,15,46,0.326086957,0.913,25,48,0.520833333,Jazz,Utah,240,21,23,9,27,36,24,9,3,9,21,116,-8
22000507,MIA,1610612748,44,86,0.512,14,31,0.451612903,0.88,30,55,0.545454545,Heat,Miami,240,22,25,11,39,50,24,5,1,15,21,124,8
22000508,PHX,1610612756,44,88,0.5,6,22,0.272727273,0.8,38,66,0.575757576,Suns,Phoenix,240,12,15,3,27,30,35,11,4,7,11,106,9
22000508,CHI,1610612741,39,78,0.5,12,31,0.387096774,0.7,27,47,0.574468085,Bulls,Chicago,240,7,10,6,35,41,25,2,4,17,16,97,-9
22000509,MEM,1610612763,39,97,0.402,9,28,0.321428571,0.75,30,69,0.434782609,Grizzlies,Memphis,240,12,16,8,29,37,24,10,4,9,14,99,-20
22000509,LAC,1610612746,44,80,0.55,14,35,0.4,0.944,30,45,0.666666667,Clippers,LA,240,17,18,4,43,47,34,6,8,17,19,119,20
22000510,OKC,1610612760,46,88,0.523,16,42,0.380952381,0.625,30,46,0.652173913,Thunder,Oklahoma City,240,10,16,5,34,39,31,6,2,10,17,118,9
22000510,ATL,1610612737,43,97,0.443,12,40,0.3,0.647,31,57,0.543859649,Hawks,Atlanta,240,11,17,19,35,54,21,6,5,10,13,109,-9
22000511,GSW,1610612744,48,79,0.608,11,24,0.458333333,0.92,37,55,0.672727273,Warriors,Golden State,240,23,25,4,33,37,38,10,3,23,19,130,9
22000511,CHA,1610612766,41,89,0.461,17,41,0.414634146,0.688,24,48,0.5,Hornets,Charlotte,240,22,32,13,25,38,27,11,1,20,23,121,-9
22000512,POR,1610612757,32,83,0.386,11,37,0.297297297,0.9,21,46,0.456521739,Trail Blazers,Portland,240,18,20,10,35,45,19,5,5,15,21,93,-9
22000512,LAL,1610612747,37,88,0.42,7,27,0.259259259,0.75,30,61,0.491803279,Lakers,Los Angeles,240,21,28,15,37,52,25,9,7,9,23,102,9
22000513,PHI,1610612755,38,83,0.458,10,28,0.357142857,0.657,28,55,0.509090909,76ers,Philadelphia,265,23,35,8,38,46,25,9,10,19,26,109,-3
22000513,CLE,1610612739,41,97,0.423,8,24,0.333333333,0.759,33,73,0.452054795,Cavaliers,Cleveland,265,22,29,13,39,52,24,12,3,16,26,112,3
22000514,SAS,1610612759,41,86,0.477,12,32,0.375,0.821,29,54,0.537037037,Spurs,San Antonio,240,23,28,8,30,38,24,7,5,8,26,117,3
22000514,NOP,1610612740,40,91,0.44,9,32,0.28125,0.806,31,59,0.525423729,Pelicans,New Orleans,240,25,31,17,35,52,27,3,2,10,17,114,-3
22000515,NYK,1610612752,40,81,0.494,12,24,0.5,0.818,28,57,0.49122807,Knicks,New York,240,18,22,4,34,38,26,12,2,18,22,110,3
22000515,IND,1610612754,38,84,0.452,11,28,0.392857143,0.8,27,56,0.482142857,Pacers,Indiana,240,20,25,6,29,35,27,5,7,16,17,107,-3
22000516,UTA,1610612762,45,85,0.529,17,45,0.377777778,0.708,28,40,0.7,Jazz,Utah,240,17,24,10,42,52,29,2,3,12,14,124,15
22000516,ORL,1610612753,44,96,0.458,14,34,0.411764706,0.875,30,62,0.483870968,Magic,Orlando,240,7,8,7,30,37,27,6,3,3,18,109,-15
22000517,WAS,1610612764,44,98,0.449,13,33,0.393939394,0.794,31,65,0.476923077,Wizards,Washington,240,27,34,15,42,57,27,6,6,16,24,128,16
22000517,MIN,1610612750,41,95,0.432,11,35,0.314285714,0.655,30,60,0.5,Timberwolves,Minnesota,240,19,29,12,38,50,23,9,10,18,29,112,-16
22000518,OKC,1610612760,37,88,0.42,11,47,0.234042553,0.733,26,41,0.634146341,Thunder,Oklahoma City,240,11,15,7,30,37,24,7,6,14,16,96,-30
22000518,DEN,1610612743,49,89,0.551,15,31,0.483870968,0.813,34,58,0.586206897,Nuggets,Denver,240,13,16,6,43,49,30,6,3,12,16,126,30
22000519,DAL,1610612742,45,86,0.523,14,36,0.388888889,0.647,31,50,0.62,Mavericks,Dallas,240,11,17,6,30,36,23,12,8,8,15,115,17
22000519,BKN,1610612751,35,86,0.407,14,44,0.318181818,0.737,21,42,0.5,Nets,Brooklyn,240,14,19,14,33,47,21,5,4,19,16,98,-17
22000520,MIL,1610612749,38,85,0.447,12,38,0.315789474,0.773,26,47,0.553191489,Bucks,Milwaukee,240,17,22,8,40,48,21,7,5,11,11,105,5
22000520,LAC,1610612746,40,97,0.412,14,44,0.318181818,0.857,26,53,0.490566038,Clippers,LA,240,6,7,13,36,49,20,7,3,8,19,100,-5
22000521,NYK,1610612752,44,86,0.512,13,26,0.5,0.8,31,60,0.516666667,Knicks,New York,240,8,10,6,35,41,23,9,7,11,23,109,19
22000521,DET,1610612765,28,72,0.389,9,32,0.28125,0.806,19,40,0.475,Pistons,Detroit,240,25,31,7,33,40,16,8,4,15,15,90,-19
22000522,MIA,1610612748,39,86,0.453,11,37,0.297297297,0.909,28,49,0.571428571,Heat,Miami,240,20,22,12,33,45,27,8,6,14,20,109,10
22000522,ATL,1610612737,36,87,0.414,8,35,0.228571429,0.864,28,52,0.538461538,Hawks,Atlanta,240,19,22,16,33,49,22,12,6,16,20,99,-10
22000523,TOR,1610612761,42,97,0.433,11,34,0.323529412,0.818,31,63,0.492063492,Raptors,Toronto,240,18,22,15,26,41,19,10,4,10,20,113,-9
22000523,CHI,1610612741,47,87,0.54,12,30,0.4,0.889,35,57,0.614035088,Bulls,Chicago,240,16,18,12,37,49,35,5,3,16,16,122,9
22000524,WAS,1610612764,38,84,0.452,9,32,0.28125,0.862,29,52,0.557692308,Wizards,Washington,240,25,29,7,29,36,16,10,5,14,22,110,-1
22000524,BOS,1610612738,42,89,0.472,10,30,0.333333333,0.708,32,59,0.542372881,Celtics,Boston,240,17,24,13,36,49,25,7,0,18,25,111,1
22000525,MEM,1610612763,50,94,0.532,10,30,0.333333333,0.821,40,64,0.625,Grizzlies,Memphis,240,23,28,11,45,56,27,16,3,18,31,133,49
22000525,HOU,1610612745,23,83,0.277,4,45,0.088888889,0.829,19,38,0.5,Rockets,Houston,240,34,41,12,26,38,10,7,6,23,24,84,-49
22000526,PHX,1610612756,44,89,0.494,7,27,0.259259259,0.958,37,62,0.596774194,Suns,Phoenix,240,23,24,8,39,47,27,7,5,16,18,118,19
22000526,MIN,1610612750,35,93,0.376,8,35,0.228571429,0.875,27,58,0.465517241,Timberwolves,Minnesota,240,21,24,10,34,44,21,12,4,15,22,99,-19
22000527,LAL,1610612747,40,85,0.471,11,31,0.35483871,0.684,29,54,0.537037037,Lakers,Los Angeles,240,26,38,14,46,60,22,14,6,19,21,117,26
22000527,GSW,1610612744,35,86,0.407,8,34,0.235294118,0.684,27,52,0.519230769,Warriors,Golden State,240,13,19,3,32,35,26,10,4,20,25,91,-26
22000528,SAC,1610612758,50,92,0.543,16,36,0.444444444,0.588,34,56,0.607142857,Kings,Sacramento,240,10,17,9,24,33,32,6,2,10,19,126,-1
22000528,CHA,1610612766,45,83,0.542,11,30,0.366666667,0.963,34,53,0.641509434,Hornets,Charlotte,240,26,27,7,30,37,30,3,6,16,20,127,1
22000529,ORL,1610612753,47,95,0.495,20,41,0.487804878,0.714,27,54,0.5,Magic,Orlando,240,10,14,6,35,41,25,5,1,8,17,124,-6
22000529,DAL,1610612742,47,90,0.522,17,46,0.369565217,0.826,30,44,0.681818182,Mavericks,Dallas,240,19,23,7,39,46,29,6,6,8,12,130,6
22000530,PHI,1610612755,50,88,0.568,15,35,0.428571429,0.938,35,53,0.660377358,76ers,Philadelphia,240,15,16,6,33,39,27,10,6,19,19,130,16
22000530,IND,1610612754,44,91,0.484,8,29,0.275862069,0.857,36,62,0.580645161,Pacers,Indiana,240,18,21,8,26,34,27,8,1,19,19,114,-16
22000531,DEN,1610612743,46,87,0.529,10,27,0.37037037,0.8,36,60,0.6,Nuggets,Denver,240,16,20,9,41,50,22,4,6,12,18,118,6
22000531,CHI,1610612741,42,94,0.447,12,38,0.315789474,0.727,30,56,0.535714286,Bulls,Chicago,240,16,22,14,30,44,25,7,3,10,18,112,-6
22000532,HOU,1610612745,31,76,0.408,10,31,0.322580645,0.75,21,45,0.466666667,Rockets,Houston,240,18,24,4,26,30,13,13,4,14,18,90,-11
22000532,CLE,1610612739,36,73,0.493,10,30,0.333333333,0.792,26,43,0.604651163,Cavaliers,Cleveland,240,19,24,6,42,48,23,7,6,19,18,101,11
22000533,UTA,1610612762,46,101,0.455,17,43,0.395348837,0.833,29,58,0.5,Jazz,Utah,240,15,18,11,28,39,26,11,7,8,22,124,-5
22000533,NOP,1610612740,52,92,0.565,7,11,0.636363636,0.783,45,81,0.555555556,Pelicans,New Orleans,240,18,23,10,43,53,27,5,5,13,15,129,5
22000534,SAS,1610612759,44,97,0.454,15,35,0.428571429,0.667,29,62,0.467741935,Spurs,San Antonio,265,10,15,9,39,48,30,2,3,9,16,113,-11
22000534,BKN,1610612751,47,100,0.47,17,41,0.414634146,0.765,30,59,0.508474576,Nets,Brooklyn,265,13,17,13,38,51,35,6,8,5,13,124,11
22000535,POR,1610612757,46,86,0.535,24,46,0.52173913,0.7,22,40,0.55,Trail Blazers,Portland,240,7,10,8,30,38,26,12,7,15,15,123,12
22000535,CHA,1610612766,43,88,0.489,15,34,0.441176471,0.588,28,54,0.518518519,Hornets,Charlotte,240,10,17,11,26,37,25,12,5,16,16,111,-12
22000536,WAS,1610612764,41,81,0.506,11,31,0.35483871,0.72,30,50,0.6,Wizards,Washington,240,18,25,4,33,37,29,8,3,22,20,111,-14
22000536,MEM,1610612763,47,95,0.495,13,29,0.448275862,0.783,34,66,0.515151515,Grizzlies,Memphis,240,18,23,9,35,44,26,15,1,11,21,125,14
22000537,LAC,1610612746,43,87,0.494,18,38,0.473684211,0.889,25,49,0.510204082,Clippers,LA,240,8,9,10,25,35,28,3,5,9,19,112,-5
22000537,BOS,1610612738,42,86,0.488,16,32,0.5,0.739,26,54,0.481481481,Celtics,Boston,240,17,23,14,29,43,25,6,4,8,12,117,5
22000538,MIA,1610612748,28,75,0.373,9,33,0.272727273,0.682,19,42,0.452380952,Heat,Miami,240,15,22,5,21,26,15,16,4,7,13,80,-14
22000538,ATL,1610612737,34,71,0.479,13,36,0.361111111,0.867,21,35,0.6,Hawks,Atlanta,240,13,15,11,36,47,26,5,2,23,18,94,14
22000539,TOR,1610612761,34,77,0.442,12,36,0.333333333,0.833,22,41,0.536585366,Raptors,Toronto,240,25,30,7,27,34,17,6,5,14,20,105,-24
22000539,DET,1610612765,48,91,0.527,20,41,0.487804878,0.619,28,50,0.56,Pistons,Detroit,240,13,21,12,37,49,39,11,4,12,28,129,24
22000540,MIL,1610612749,32,79,0.405,11,40,0.275,0.71,21,39,0.538461538,Bucks,Milwaukee,240,22,31,11,29,40,22,4,4,13,18,97,-31
22000540,DEN,1610612743,53,95,0.558,11,30,0.366666667,0.917,42,65,0.646153846,Nuggets,Denver,240,11,12,9,36,45,28,10,3,10,19,128,31
22000541,SAS,1610612759,43,89,0.483,18,42,0.428571429,0.714,25,47,0.531914894,Spurs,San Antonio,240,15,21,9,36,45,31,12,4,8,14,119,26
22000541,NYK,1610612752,33,81,0.407,15,36,0.416666667,0.8,18,45,0.4,Knicks,New York,240,12,15,9,32,41,18,2,5,16,16,93,-26
22000542,PHX,1610612756,38,77,0.494,16,29,0.551724138,0.88,22,48,0.458333333,Suns,Phoenix,240,22,25,5,30,35,30,5,7,13,16,114,10
22000542,LAL,1610612747,40,79,0.506,11,31,0.35483871,0.765,29,48,0.604166667,Lakers,Los Angeles,240,13,17,5,29,34,18,6,8,12,23,104,-10
22000543,IND,1610612754,47,83,0.566,8,25,0.32,0.75,39,58,0.672413793,Pacers,Indiana,240,12,16,4,23,27,27,18,8,11,16,114,3
22000543,CLE,1610612739,43,83,0.518,11,28,0.392857143,0.933,32,55,0.581818182,Cavaliers,Cleveland,240,14,15,11,32,43,29,8,1,25,18,111,-3
22000544,ORL,1610612753,36,84,0.429,13,35,0.371428571,1,23,49,0.469387755,Magic,Orlando,240,27,27,10,36,46,24,6,5,10,15,112,-3
22000544,ATL,1610612737,38,85,0.447,21,45,0.466666667,0.947,17,40,0.425,Hawks,Atlanta,240,18,19,6,36,42,26,7,5,12,25,115,3
22000545,UTA,1610612762,44,100,0.44,21,44,0.477272727,0.737,23,56,0.410714286,Jazz,Utah,265,14,19,12,40,52,22,7,1,16,24,123,-8
22000545,PHI,1610612755,48,93,0.516,8,25,0.32,0.771,40,68,0.588235294,76ers,Philadelphia,265,27,35,8,42,50,22,9,6,11,17,131,8
22000546,HOU,1610612745,38,91,0.418,18,43,0.418604651,0.714,20,48,0.416666667,Rockets,Houston,240,20,28,12,25,37,24,10,5,9,18,114,-18
22000546,BKN,1610612751,49,85,0.576,17,35,0.485714286,0.708,32,50,0.64,Nets,Brooklyn,240,17,24,10,43,53,33,5,1,14,24,132,18
22000547,MIN,1610612750,39,96,0.406,9,40,0.225,0.833,30,56,0.535714286,Timberwolves,Minnesota,240,15,18,12,33,45,25,11,2,19,18,102,-33
22000547,CHA,1610612766,51,98,0.52,17,39,0.435897436,0.762,34,59,0.576271186,Hornets,Charlotte,240,16,21,13,41,54,33,14,7,17,18,135,33
22000548,NOP,1610612740,46,83,0.554,6,22,0.272727273,0.684,40,61,0.655737705,Pelicans,New Orleans,240,26,38,7,28,35,29,10,6,11,19,124,-4
22000548,CHI,1610612741,48,94,0.511,12,28,0.428571429,0.909,36,66,0.545454545,Bulls,Chicago,240,20,22,13,32,45,28,6,8,14,21,128,4
22000549,OKC,1610612760,29,87,0.333,9,39,0.230769231,0.647,20,48,0.416666667,Thunder,Oklahoma City,240,11,17,8,37,45,13,6,4,13,20,78,-9
22000549,DAL,1610612742,32,83,0.386,8,40,0.2,0.789,24,43,0.558139535,Mavericks,Dallas,240,15,19,7,46,53,18,8,3,12,13,87,9
22000550,POR,1610612757,36,86,0.419,14,49,0.285714286,0.846,22,37,0.594594595,Trail Blazers,Portland,240,22,26,8,39,47,15,5,4,10,16,108,2
22000550,GSW,1610612744,41,97,0.423,15,42,0.357142857,0.643,26,55,0.472727273,Warriors,Golden State,240,9,14,17,37,54,27,8,1,11,24,106,-2
22000551,SAC,1610612758,48,80,0.6,12,25,0.48,0.789,36,55,0.654545455,Kings,Sacramento,240,15,19,6,24,30,32,5,1,13,19,123,3
22000551,LAL,1610612747,49,93,0.527,12,27,0.444444444,0.714,37,66,0.560606061,Lakers,Los Angeles,240,10,14,15,26,41,27,7,3,11,19,120,-3
22000552,TOR,1610612761,45,91,0.495,21,50,0.42,0.824,24,41,0.585365854,Raptors,Toronto,240,14,17,8,20,28,36,6,1,13,25,125,-7
22000552,BOS,1610612738,45,74,0.608,13,29,0.448275862,0.725,32,45,0.711111111,Celtics,Boston,240,29,40,9,30,39,25,6,7,16,20,132,7
22000553,IND,1610612754,41,90,0.456,14,39,0.358974359,0.583,27,51,0.529411765,Pacers,Indiana,240,7,12,11,23,34,27,12,3,14,17,103,-10
22000553,DEN,1610612743,45,77,0.584,12,28,0.428571429,0.688,33,49,0.673469388,Nuggets,Denver,240,11,16,6,35,41,27,6,5,19,13,113,10
22000554,WAS,1610612764,40,88,0.455,9,23,0.391304348,0.714,31,65,0.476923077,Wizards,Washington,240,30,42,11,30,41,20,12,3,9,24,119,2
22000554,LAC,1610612746,38,82,0.463,16,35,0.457142857,0.926,22,47,0.468085106,Clippers,LA,240,25,27,10,35,45,24,4,4,17,31,117,-2
22000555,MIL,1610612749,42,95,0.442,10,34,0.294117647,0.818,32,61,0.524590164,Bucks,Milwaukee,240,18,22,13,39,52,21,11,5,16,19,112,1
22000555,MEM,1610612763,40,101,0.396,8,34,0.235294118,0.958,32,67,0.47761194,Grizzlies,Memphis,240,23,24,17,39,56,21,13,8,12,20,111,-1
22000556,SAS,1610612759,40,85,0.471,10,31,0.322580645,1,30,54,0.555555556,Spurs,San Antonio,240,12,12,6,40,46,23,9,5,19,24,102,-5
22000556,OKC,1610612760,37,85,0.435,12,40,0.3,0.808,25,45,0.555555556,Thunder,Oklahoma City,240,21,26,9,36,45,20,9,4,16,16,107,5
22000557,NOP,1610612740,33,84,0.393,11,43,0.255813953,0.8,22,41,0.536585366,Pelicans,New Orleans,240,16,20,15,29,44,28,5,3,12,21,93,-10
22000557,MIA,1610612748,36,73,0.493,10,30,0.333333333,0.84,26,43,0.604651163,Heat,Miami,240,21,25,5,36,41,27,6,3,10,20,103,10
22000558,SAC,1610612758,49,103,0.476,11,29,0.379310345,0.625,38,74,0.513513514,Kings,Sacramento,240,10,16,18,33,51,25,3,3,7,19,119,-4
22000558,POR,1610612757,42,88,0.477,15,38,0.394736842,0.96,27,50,0.54,Trail Blazers,Portland,240,24,25,9,32,41,20,6,7,8,14,123,4
22000559,WAS,1610612764,46,83,0.554,16,40,0.4,0.765,30,43,0.697674419,Wizards,Washington,240,13,17,6,33,39,32,2,5,13,21,121,-11
22000559,POR,1610612757,44,95,0.463,21,46,0.456521739,1,23,49,0.469387755,Trail Blazers,Portland,240,23,23,14,30,44,19,6,1,9,19,132,11
22000560,WAS,1610612764,33,83,0.398,7,30,0.233333333,0.861,26,53,0.490566038,Wizards,Washington,240,31,36,9,45,54,24,9,3,16,25,104,13
22000560,BOS,1610612738,32,90,0.356,9,35,0.257142857,0.6,23,55,0.418181818,Celtics,Boston,240,18,30,14,36,50,14,5,2,17,27,91,-13
22000561,NOP,1610612740,40,90,0.444,9,35,0.257142857,0.821,31,55,0.563636364,Pelicans,New Orleans,240,23,28,18,26,44,23,5,2,10,17,112,-11
22000561,DET,1610612765,45,84,0.536,17,35,0.485714286,0.8,28,49,0.571428571,Pistons,Detroit,240,16,20,9,28,37,34,3,8,11,23,123,11
22000562,OKC,1610612760,35,78,0.449,19,41,0.463414634,0.857,16,37,0.432432432,Thunder,Oklahoma City,240,24,28,6,33,39,25,5,3,18,25,113,-9
22000562,MEM,1610612763,42,83,0.506,12,26,0.461538462,0.788,30,57,0.526315789,Grizzlies,Memphis,240,26,33,7,37,44,31,14,4,12,18,122,9
22000563,DEN,1610612743,46,80,0.575,15,31,0.483870968,0.765,31,49,0.632653061,Nuggets,Denver,240,13,17,6,31,37,24,9,2,15,17,120,17
22000563,CLE,1610612739,39,83,0.47,12,31,0.387096774,0.619,27,52,0.519230769,Cavaliers,Cleveland,240,13,21,13,21,34,30,8,4,18,15,103,-17
22000564,DET,1610612765,37,82,0.451,8,28,0.285714286,0.833,29,54,0.537037037,Pistons,Detroit,240,20,24,6,34,40,15,9,2,13,21,102,-3
22000564,CHI,1610612741,41,85,0.482,8,28,0.285714286,0.625,33,57,0.578947368,Bulls,Chicago,240,15,24,8,38,46,29,8,7,13,20,105,3
22000565,NYK,1610612752,45,83,0.542,9,27,0.333333333,0.789,36,56,0.642857143,Knicks,New York,240,15,19,12,35,47,25,10,4,13,13,114,10
22000565,DET,1610612765,39,80,0.487,14,36,0.388888889,0.8,25,44,0.568181818,Pistons,Detroit,240,12,15,6,23,29,23,6,2,12,13,104,-10
22000566,WAS,1610612764,38,95,0.4,11,36,0.305555556,0.926,27,59,0.457627119,Wizards,Washington,240,25,27,6,33,39,23,9,6,9,26,112,-15
22000566,MEM,1610612763,50,99,0.505,8,23,0.347826087,0.655,42,76,0.552631579,Grizzlies,Memphis,240,19,29,14,46,60,31,4,6,15,26,127,15
22000567,SAS,1610612759,38,83,0.458,12,28,0.428571429,0.8,26,55,0.472727273,Spurs,San Antonio,240,16,20,6,24,30,18,10,2,9,19,104,-11
22000567,DAL,1610612742,43,83,0.518,13,40,0.325,0.842,30,43,0.697674419,Mavericks,Dallas,240,16,19,13,38,51,29,3,1,14,19,115,11
22000568,DET,1610612765,38,85,0.447,15,46,0.326086957,0.786,23,39,0.58974359,Pistons,Detroit,240,11,14,11,39,50,27,6,5,14,21,102,-3
22000568,CHA,1610612766,36,90,0.4,10,30,0.333333333,0.958,26,60,0.433333333,Hornets,Charlotte,240,23,24,12,33,45,26,9,3,9,14,105,3
22000569,BOS,1610612738,41,91,0.451,13,40,0.325,0.636,28,51,0.549019608,Celtics,Boston,240,14,22,11,28,39,22,10,10,11,13,109,-12
22000569,BKN,1610612751,42,88,0.477,19,42,0.452380952,0.818,23,46,0.5,Nets,Brooklyn,240,18,22,11,34,45,21,3,5,14,22,121,12
22000570,TOR,1610612761,42,96,0.438,17,37,0.459459459,0.826,25,59,0.423728814,Raptors,Toronto,240,19,23,13,37,50,23,8,4,14,25,120,-1
22000570,ATL,1610612737,39,90,0.433,15,42,0.357142857,0.8,24,48,0.5,Hawks,Atlanta,240,28,35,12,41,53,20,8,13,14,26,121,1
22000571,ORL,1610612753,39,96,0.406,12,34,0.352941176,0.867,27,62,0.435483871,Magic,Orlando,240,13,15,16,41,57,22,6,4,14,19,103,-8
22000571,MIA,1610612748,41,91,0.451,16,49,0.326530612,0.591,25,42,0.595238095,Heat,Miami,240,13,22,9,35,44,27,8,4,10,16,111,8
22000572,PHI,1610612755,53,103,0.515,10,33,0.303030303,0.733,43,70,0.614285714,76ers,Philadelphia,240,11,15,13,32,45,25,11,7,10,16,127,22
22000572,CHI,1610612741,39,83,0.47,14,29,0.482758621,0.813,25,54,0.462962963,Bulls,Chicago,240,13,16,8,30,38,26,3,6,19,19,105,-22
22000573,NYK,1610612752,37,88,0.42,13,37,0.351351351,0.667,24,51,0.470588235,Knicks,New York,240,14,21,10,28,38,19,3,5,14,19,101,-33
22000573,MIL,1610612749,50,87,0.575,18,38,0.473684211,0.941,32,49,0.653061224,Bucks,Milwaukee,240,16,17,5,38,43,29,9,9,12,18,134,33
22000574,NOP,1610612740,43,100,0.43,6,32,0.1875,0.542,37,68,0.544117647,Pelicans,New Orleans,240,13,24,19,32,51,28,7,6,18,18,105,-30
22000574,MIN,1610612750,51,95,0.537,19,40,0.475,0.875,32,55,0.581818182,Timberwolves,Minnesota,240,14,16,7,31,38,28,11,10,11,20,135,30
22000575,OKC,1610612760,41,91,0.451,16,32,0.5,0.9,25,59,0.423728814,Thunder,Oklahoma City,240,18,20,16,39,55,25,2,6,9,24,116,8
22000575,DAL,1610612742,35,82,0.427,15,34,0.441176471,0.697,20,48,0.416666667,Mavericks,Dallas,240,23,33,6,31,37,20,4,9,6,22,108,-8
22000576,LAC,1610612746,44,96,0.458,18,41,0.43902439,0.828,26,55,0.472727273,Clippers,LA,240,24,29,11,45,56,23,10,6,11,22,130,26
22000576,GSW,1610612744,38,88,0.432,9,36,0.25,0.704,29,52,0.557692308,Warriors,Golden State,240,19,27,5,39,44,20,6,6,16,23,104,-26
22000577,POR,1610612757,43,94,0.457,18,43,0.418604651,0.895,25,51,0.490196078,Trail Blazers,Portland,240,17,19,15,26,41,26,8,2,11,18,121,-6
22000577,PHX,1610612756,49,83,0.59,13,24,0.541666667,0.842,36,59,0.610169492,Suns,Phoenix,240,16,19,5,33,38,28,6,1,13,20,127,6
22000578,SAC,1610612758,45,92,0.489,11,33,0.333333333,0.857,34,59,0.576271186,Kings,Sacramento,240,24,28,8,45,53,25,11,5,12,19,125,20
22000578,HOU,1610612745,41,99,0.414,11,45,0.244444444,0.706,30,54,0.555555556,Rockets,Houston,240,12,17,10,34,44,24,7,6,13,22,105,-20
22000579,WAS,1610612764,40,82,0.488,8,24,0.333333333,0.591,32,58,0.551724138,Wizards,Washington,240,13,22,6,26,32,19,10,2,18,16,101,-26
22000579,PHI,1610612755,49,90,0.544,11,21,0.523809524,1,38,69,0.550724638,76ers,Philadelphia,240,18,18,10,39,49,26,13,6,16,19,127,26
22000580,MEM,1610612763,40,87,0.46,14,28,0.5,1,26,59,0.440677966,Grizzlies,Memphis,240,8,8,8,37,45,27,6,5,16,15,102,-1
22000580,DEN,1610612743,41,92,0.446,13,37,0.351351351,0.727,28,55,0.509090909,Nuggets,Denver,240,8,11,9,36,45,27,10,5,9,10,103,1
22000581,NOP,1610612740,47,101,0.465,6,24,0.25,0.842,41,77,0.532467532,Pelicans,New Orleans,240,16,19,19,51,70,25,2,7,13,18,116,34
22000581,CLE,1610612739,30,88,0.341,7,32,0.21875,0.75,23,56,0.410714286,Cavaliers,Cleveland,240,15,20,5,28,33,13,8,9,6,18,82,-34
22000582,MIA,1610612748,37,80,0.463,12,35,0.342857143,0.75,25,45,0.555555556,Heat,Miami,240,15,20,1,40,41,26,11,6,9,13,101,11
22000582,CHI,1610612741,34,92,0.37,15,38,0.394736842,1,19,54,0.351851852,Bulls,Chicago,240,7,7,12,38,50,25,5,3,16,16,90,-11
22000583,SAS,1610612759,40,89,0.449,10,29,0.344827586,0.778,30,60,0.5,Spurs,San Antonio,240,14,18,7,38,45,24,8,5,9,15,104,27
22000583,ORL,1610612753,29,80,0.362,10,38,0.263157895,0.75,19,42,0.452380952,Magic,Orlando,240,9,12,9,37,46,17,3,4,18,16,77,-27
22000584,UTA,1610612762,39,81,0.481,15,40,0.375,0.84,24,41,0.585365854,Jazz,Utah,240,21,25,6,45,51,24,7,10,17,17,114,15
22000584,HOU,1610612745,41,112,0.366,9,43,0.209302326,0.615,32,69,0.463768116,Rockets,Houston,240,8,13,19,31,50,15,11,5,10,19,99,-15
22000585,LAL,1610612747,34,76,0.447,7,22,0.318181818,0.769,27,54,0.5,Lakers,Los Angeles,240,30,39,6,38,44,20,10,5,15,20,105,5
22000585,IND,1610612754,37,88,0.42,8,36,0.222222222,0.857,29,52,0.557692308,Pacers,Indiana,240,18,21,10,34,44,22,7,4,16,27,100,-5
22000586,OKC,1610612760,37,76,0.487,8,32,0.25,0.714,29,44,0.659090909,Thunder,Oklahoma City,240,15,21,5,35,40,22,3,4,18,18,97,-22
22000586,NYK,1610612752,44,90,0.489,14,35,0.4,0.773,30,55,0.545454545,Knicks,New York,240,17,22,11,33,44,23,12,2,10,20,119,22
22000587,DET,1610612765,36,89,0.404,8,32,0.25,0.75,28,57,0.49122807,Pistons,Detroit,240,15,20,12,34,46,26,10,8,12,16,95,-5
22000587,BKN,1610612751,39,80,0.487,6,27,0.222222222,0.727,33,53,0.622641509,Nets,Brooklyn,240,16,22,5,30,35,22,8,7,12,16,100,5
22000588,TOR,1610612761,37,96,0.385,15,46,0.326086957,0.833,22,50,0.44,Raptors,Toronto,240,15,18,13,34,47,25,10,6,16,16,104,-10
22000588,CHA,1610612766,39,81,0.481,21,49,0.428571429,0.789,18,32,0.5625,Hornets,Charlotte,240,15,19,8,43,51,30,10,6,27,22,114,10
22000589,WAS,1610612764,43,94,0.457,16,41,0.390243902,0.773,27,53,0.509433962,Wizards,Washington,240,17,22,6,35,41,25,9,2,15,20,119,-6
22000589,MIL,1610612749,43,99,0.434,17,45,0.377777778,0.88,26,54,0.481481481,Bucks,Milwaukee,240,22,25,13,44,57,33,9,3,18,19,125,6
22000590,SAC,1610612758,43,98,0.439,7,36,0.194444444,0.813,36,62,0.580645161,Kings,Sacramento,240,13,16,22,25,47,27,5,1,12,26,106,-15
22000590,ATL,1610612737,43,84,0.512,12,33,0.363636364,0.697,31,51,0.607843137,Hawks,Atlanta,240,23,33,13,32,45,21,6,2,8,17,121,15
22000591,POR,1610612757,43,89,0.483,13,40,0.325,0.867,30,49,0.612244898,Trail Blazers,Portland,240,26,30,7,27,34,26,6,5,8,18,125,4
22000591,MIN,1610612750,44,86,0.512,10,26,0.384615385,0.742,34,60,0.566666667,Timberwolves,Minnesota,240,23,31,19,37,56,23,5,7,18,24,121,-4
22000592,DEN,1610612743,37,90,0.411,16,41,0.390243902,0.722,21,49,0.428571429,Nuggets,Denver,240,13,18,12,30,42,27,5,1,10,19,103,-13
22000592,DAL,1610612742,42,86,0.488,18,46,0.391304348,0.875,24,40,0.6,Mavericks,Dallas,240,14,16,11,37,48,26,5,3,8,19,116,13
22000593,OKC,1610612760,42,73,0.575,16,31,0.516129032,0.824,26,42,0.619047619,Thunder,Oklahoma City,240,28,34,8,38,46,26,7,4,24,20,128,6
22000593,MEM,1610612763,47,92,0.511,7,22,0.318181818,0.724,40,70,0.571428571,Grizzlies,Memphis,240,21,29,11,21,32,27,13,3,7,21,122,-6
22000594,UTA,1610612762,41,93,0.441,15,44,0.340909091,0.759,26,49,0.530612245,Jazz,Utah,240,22,29,18,33,51,24,6,6,14,16,119,-12
22000594,GSW,1610612744,50,89,0.562,16,31,0.516129032,0.833,34,58,0.586206897,Warriors,Golden State,240,15,18,5,35,40,33,12,2,13,26,131,12
22000595,SAS,1610612759,36,85,0.424,4,21,0.19047619,0.742,32,64,0.5,Spurs,San Antonio,240,23,31,10,22,32,20,8,10,9,13,99,-35
22000595,PHI,1610612755,56,98,0.571,15,29,0.517241379,0.636,41,69,0.594202899,76ers,Philadelphia,240,7,11,13,41,54,35,7,7,11,27,134,35
22000596,ORL,1610612753,33,75,0.44,16,40,0.4,0.714,17,35,0.485714286,Magic,Orlando,240,15,21,8,37,45,25,4,1,23,18,97,-5
22000596,MIA,1610612748,37,89,0.416,14,50,0.28,0.933,23,39,0.58974359,Heat,Miami,240,14,15,10,33,43,28,15,6,11,17,102,5
22000597,CLE,1610612739,31,81,0.383,8,30,0.266666667,0.522,23,51,0.450980392,Cavaliers,Cleveland,240,12,23,14,20,34,19,4,5,13,18,82,-18
22000597,ATL,1610612737,32,71,0.451,12,29,0.413793103,0.923,20,42,0.476190476,Hawks,Atlanta,240,24,26,12,37,49,21,4,6,15,21,100,18
22000598,HOU,1610612745,35,91,0.385,16,50,0.32,0.677,19,41,0.463414634,Rockets,Houston,240,21,31,10,27,37,23,8,5,11,19,107,-27
22000598,BOS,1610612738,51,92,0.554,18,37,0.486486486,0.667,33,55,0.6,Celtics,Boston,240,14,21,10,45,55,29,8,3,14,22,134,27
22000599,POR,1610612757,39,89,0.438,17,45,0.377777778,0.81,22,44,0.5,Trail Blazers,Portland,240,17,21,9,33,42,22,6,3,11,29,112,-2
22000599,MIN,1610612750,36,73,0.493,13,38,0.342105263,0.744,23,35,0.657142857,Timberwolves,Minnesota,240,29,39,5,40,45,24,6,4,12,22,114,2
22000600,TOR,1610612761,34,90,0.378,12,45,0.266666667,0.714,22,45,0.488888889,Raptors,Toronto,240,15,21,7,31,38,23,5,7,12,22,95,-23
22000600,CHI,1610612741,44,97,0.454,12,44,0.272727273,0.783,32,53,0.603773585,Bulls,Chicago,240,18,23,14,46,60,35,6,7,11,20,118,23
22000601,NOP,1610612740,53,81,0.654,12,26,0.461538462,0.81,41,55,0.745454545,Pelicans,New Orleans,240,17,21,4,36,40,38,8,1,18,16,135,20
22000601,LAC,1610612746,42,92,0.457,15,43,0.348837209,0.842,27,49,0.551020408,Clippers,LA,240,16,19,9,23,32,23,12,2,12,17,115,-20
22000602,SAC,1610612758,48,86,0.558,9,31,0.290322581,0.647,39,55,0.709090909,Kings,Sacramento,240,11,17,4,40,44,28,7,6,10,19,116,-6
22000602,CHA,1610612766,45,94,0.479,12,30,0.4,0.8,33,64,0.515625,Hornets,Charlotte,240,20,25,10,36,46,30,7,3,8,15,122,6
22000603,WAS,1610612764,44,87,0.506,16,38,0.421052632,0.75,28,49,0.571428571,Wizards,Washington,240,18,24,2,31,33,34,5,1,14,18,122,-11
22000603,MIL,1610612749,52,94,0.553,11,28,0.392857143,0.947,41,66,0.621212121,Bucks,Milwaukee,240,18,19,9,37,46,29,6,5,16,20,133,11
22000604,NYK,1610612752,37,92,0.402,15,42,0.357142857,0.852,22,50,0.44,Knicks,New York,240,23,27,13,27,40,16,9,2,8,22,112,-5
22000604,BKN,1610612751,44,76,0.579,12,29,0.413793103,0.773,32,47,0.680851064,Nets,Brooklyn,240,17,22,3,38,41,29,3,6,15,19,117,5
22000605,LAC,1610612746,43,86,0.5,14,32,0.4375,0.818,29,54,0.537037037,Clippers,LA,240,9,11,9,37,46,23,10,0,9,12,109,10
22000605,DAL,1610612742,39,79,0.494,17,41,0.414634146,0.8,22,38,0.578947368,Mavericks,Dallas,240,4,5,4,29,33,24,8,4,14,16,99,-10
22000606,IND,1610612754,39,90,0.433,17,42,0.404761905,0.846,22,48,0.458333333,Pacers,Indiana,240,11,13,10,29,39,28,8,9,11,13,106,-15
22000606,DEN,1610612743,45,97,0.464,15,28,0.535714286,0.842,30,69,0.434782609,Nuggets,Denver,240,16,19,17,37,54,32,7,7,10,15,121,15
22000607,PHX,1610612756,47,83,0.566,12,30,0.4,0.889,35,53,0.660377358,Suns,Phoenix,240,16,18,5,37,42,28,7,5,14,19,122,23
22000607,MEM,1610612763,38,87,0.437,5,23,0.217391304,0.692,33,64,0.515625,Grizzlies,Memphis,240,18,26,10,29,39,15,11,0,10,17,99,-23
22000608,LAL,1610612747,49,78,0.628,11,27,0.407407407,0.76,38,51,0.745098039,Lakers,Los Angeles,240,19,25,7,39,46,36,9,3,19,25,128,31
22000608,GSW,1610612744,34,79,0.43,13,37,0.351351351,0.667,21,42,0.5,Warriors,Golden State,240,16,24,9,21,30,24,9,2,22,23,97,-31
22000609,UTA,1610612762,38,80,0.475,19,43,0.441860465,0.917,19,37,0.513513514,Jazz,Utah,240,22,24,10,28,38,23,6,6,15,18,117,8
22000609,BOS,1610612738,48,98,0.49,10,29,0.344827586,0.75,38,69,0.550724638,Celtics,Boston,240,3,4,16,29,45,28,8,5,13,18,109,-8
22000610,MIA,1610612748,42,85,0.494,10,27,0.37037037,0.905,32,58,0.551724138,Heat,Miami,240,19,21,16,32,48,30,11,5,13,18,113,15
22000610,CLE,1610612739,39,86,0.453,10,35,0.285714286,0.714,29,51,0.568627451,Cavaliers,Cleveland,240,10,14,15,27,42,23,7,6,14,19,98,-15
22000611,PHI,1610612755,37,90,0.411,11,32,0.34375,0.737,26,58,0.448275862,76ers,Philadelphia,240,14,19,12,38,50,19,8,10,11,22,99,3
22000611,NYK,1610612752,37,84,0.44,8,24,0.333333333,0.636,29,60,0.483333333,Knicks,New York,240,14,22,9,38,47,19,7,5,12,23,96,-3
22000612,OKC,1610612760,42,90,0.467,7,20,0.35,0.846,35,70,0.5,Thunder,Oklahoma City,240,11,13,13,30,43,16,9,9,17,15,102,-21
22000612,CHI,1610612741,48,94,0.511,12,36,0.333333333,0.833,36,58,0.620689655,Bulls,Chicago,240,15,18,12,30,42,24,8,4,11,17,123,21
22000613,HOU,1610612745,42,88,0.477,13,34,0.382352941,0.769,29,54,0.537037037,Rockets,Houston,240,10,13,10,27,37,27,6,6,13,19,107,-12
22000613,ATL,1610612737,44,86,0.512,17,37,0.459459459,0.875,27,49,0.551020408,Hawks,Atlanta,240,14,16,9,29,38,32,8,6,12,18,119,12
22000614,POR,1610612757,38,73,0.521,18,43,0.418604651,1,20,30,0.666666667,Trail Blazers,Portland,240,31,31,4,28,32,20,8,8,17,19,125,1
22000614,NOP,1610612740,46,88,0.523,16,33,0.484848485,0.8,30,55,0.545454545,Pelicans,New Orleans,240,16,20,10,31,41,38,8,3,16,24,124,-1
22000615,MIN,1610612750,47,90,0.522,11,35,0.314285714,0.727,36,55,0.654545455,Timberwolves,Minnesota,240,16,22,8,26,34,28,9,6,12,21,121,-16
22000615,LAL,1610612747,50,87,0.575,13,26,0.5,0.857,37,61,0.606557377,Lakers,Los Angeles,240,24,28,10,33,43,37,3,3,13,16,137,16
22000616,TOR,1610612761,37,86,0.43,12,40,0.3,0.765,25,46,0.543478261,Raptors,Toronto,240,26,34,10,20,30,27,7,6,9,26,112,-4
22000616,DET,1610612765,38,75,0.507,12,29,0.413793103,0.875,26,46,0.565217391,Pistons,Detroit,240,28,32,13,41,54,23,8,5,20,30,116,4
22000617,IND,1610612754,43,84,0.512,9,32,0.28125,0.8,34,52,0.653846154,Pacers,Indiana,240,20,25,4,30,34,29,10,3,16,28,115,-9
22000617,BKN,1610612751,42,87,0.483,9,27,0.333333333,0.775,33,60,0.55,Nets,Brooklyn,240,31,40,15,35,50,22,10,2,16,20,124,9
22000618,PHI,1610612755,43,109,0.394,14,41,0.341463415,0.625,29,68,0.426470588,76ers,Philadelphia,265,5,8,13,46,59,28,14,7,20,23,105,-4
22000618,MIL,1610612749,41,101,0.406,9,39,0.230769231,0.75,32,62,0.516129032,Bucks,Milwaukee,265,18,24,12,46,58,22,11,1,22,11,109,4
22000619,WAS,1610612764,46,94,0.489,4,25,0.16,0.821,42,69,0.608695652,Wizards,Washington,240,23,28,10,42,52,25,5,2,15,25,119,-2
22000619,SAC,1610612758,41,93,0.441,10,33,0.303030303,0.829,31,60,0.516666667,Kings,Sacramento,240,29,35,6,32,38,25,10,4,8,26,121,2
22000620,CLE,1610612739,40,74,0.541,10,23,0.434782609,0.818,30,51,0.588235294,Cavaliers,Cleveland,240,27,33,7,33,40,23,6,3,15,17,117,7
22000620,BOS,1610612738,40,88,0.455,10,38,0.263157895,0.69,30,50,0.6,Celtics,Boston,240,20,29,15,25,40,19,10,9,12,27,110,-7
22000621,SAS,1610612759,38,89,0.427,8,31,0.258064516,0.733,30,58,0.517241379,Spurs,San Antonio,240,22,30,13,33,46,19,5,6,9,8,106,7
22000621,CHI,1610612741,40,91,0.44,11,33,0.333333333,0.889,29,58,0.5,Bulls,Chicago,240,8,9,14,37,51,24,6,3,17,22,99,-7
22000622,HOU,1610612745,33,80,0.412,7,27,0.259259259,0.525,26,53,0.490566038,Rockets,Houston,240,21,40,8,40,48,19,7,3,16,15,94,-14
22000622,GSW,1610612744,41,90,0.456,16,45,0.355555556,0.833,25,45,0.555555556,Warriors,Golden State,240,10,12,6,42,48,32,7,4,12,26,108,14
22000623,MIA,1610612748,32,89,0.36,8,34,0.235294118,0.722,24,55,0.436363636,Heat,Miami,240,13,18,8,43,51,17,4,2,10,21,85,-4
22000623,MEM,1610612763,30,85,0.353,10,42,0.238095238,0.76,20,43,0.465116279,Grizzlies,Memphis,240,19,25,8,42,50,22,5,4,9,17,89,4
22000624,DEN,1610612743,52,90,0.578,16,44,0.363636364,0.692,36,46,0.782608696,Nuggets,Denver,240,9,13,8,40,48,37,12,3,15,22,129,25
22000624,CHA,1610612766,36,80,0.45,12,38,0.315789474,0.714,24,42,0.571428571,Hornets,Charlotte,240,20,28,7,26,33,25,11,1,17,16,104,-25
22000625,LAC,1610612746,37,88,0.42,9,32,0.28125,0.545,28,56,0.5,Clippers,LA,240,6,11,8,29,37,22,12,3,12,15,89,-16
22000625,DAL,1610612742,40,79,0.506,15,34,0.441176471,0.833,25,45,0.555555556,Mavericks,Dallas,240,10,12,6,37,43,14,7,7,18,16,105,16
22000626,OKC,1610612760,34,93,0.366,13,34,0.382352941,0.75,21,59,0.355932203,Thunder,Oklahoma City,240,12,16,11,27,38,18,5,3,9,13,93,-23
22000626,ATL,1610612737,47,87,0.54,11,33,0.333333333,0.846,36,54,0.666666667,Hawks,Atlanta,240,11,13,6,44,50,26,6,7,14,16,116,23
22000627,ORL,1610612753,35,82,0.427,10,34,0.294117647,0.813,25,48,0.520833333,Magic,Orlando,240,13,16,8,41,49,21,6,6,10,13,93,-1
22000627,NYK,1610612752,37,86,0.43,14,34,0.411764706,0.545,23,52,0.442307692,Knicks,New York,240,6,11,5,38,43,24,6,4,7,14,94,1
22000628,PHX,1610612756,45,85,0.529,15,36,0.416666667,0.737,30,49,0.612244898,Suns,Phoenix,240,14,19,9,38,47,29,6,6,22,30,119,-4
22000628,MIN,1610612750,44,93,0.473,11,34,0.323529412,0.686,33,59,0.559322034,Timberwolves,Minnesota,240,24,35,11,27,38,22,14,4,12,16,123,4
22000629,POR,1610612757,33,87,0.379,14,43,0.325581395,0.84,19,44,0.431818182,Trail Blazers,Portland,240,21,25,14,36,50,11,8,8,13,19,101,8
22000629,NOP,1610612740,33,83,0.398,10,37,0.27027027,0.68,23,46,0.5,Pelicans,New Orleans,240,17,25,10,34,44,24,6,5,12,19,93,-8
22000630,LAL,1610612747,44,92,0.478,13,39,0.333333333,0.75,31,53,0.58490566,Lakers,Los Angeles,240,15,20,11,37,48,23,7,6,11,19,116,11
22000630,CHA,1610612766,41,83,0.494,11,29,0.379310345,0.6,30,54,0.555555556,Hornets,Charlotte,240,12,20,8,36,44,26,7,8,19,19,105,-11
22000631,SAC,1610612758,37,81,0.457,12,30,0.4,0.808,25,51,0.490196078,Kings,Sacramento,240,21,26,11,34,45,22,6,9,14,16,107,11
22000631,BOS,1610612738,39,91,0.429,12,31,0.387096774,0.857,27,60,0.45,Celtics,Boston,240,6,7,12,33,45,22,8,4,14,20,96,-11
22000632,MIA,1610612748,41,92,0.446,9,34,0.264705882,0.95,32,58,0.551724138,Heat,Miami,240,19,20,10,26,36,22,10,4,11,17,110,-27
22000632,IND,1610612754,52,89,0.584,20,36,0.555555556,0.684,32,53,0.603773585,Pacers,Indiana,240,13,19,9,38,47,38,7,9,16,17,137,27
22000633,ORL,1610612753,43,84,0.512,21,40,0.525,0.7,22,44,0.5,Magic,Orlando,240,14,20,8,36,44,26,4,1,17,20,121,8
22000633,BKN,1610612751,43,91,0.473,10,37,0.27027027,0.739,33,54,0.611111111,Nets,Brooklyn,240,17,23,9,30,39,24,9,3,8,16,113,-8
22000634,UTA,1610612762,34,74,0.459,12,37,0.324324324,0.854,22,37,0.594594595,Jazz,Utah,240,35,41,9,39,48,21,7,5,13,16,115,3
22000634,TOR,1610612761,40,83,0.482,21,44,0.477272727,0.786,19,39,0.487179487,Raptors,Toronto,240,11,14,3,28,31,31,9,4,10,28,112,-3
22000635,HOU,1610612745,39,88,0.443,9,32,0.28125,0.813,30,56,0.535714286,Rockets,Houston,240,13,16,7,31,38,21,7,4,13,17,100,-13
22000635,DET,1610612765,37,85,0.435,14,29,0.482758621,0.893,23,56,0.410714286,Pistons,Detroit,240,25,28,12,37,49,28,7,4,13,17,113,13
22000636,MEM,1610612763,39,84,0.464,8,26,0.307692308,0.81,31,58,0.534482759,Grizzlies,Memphis,240,17,21,9,37,46,24,10,6,20,17,103,-13
22000636,GSW,1610612744,44,91,0.484,15,41,0.365853659,0.722,29,50,0.58,Warriors,Golden State,240,13,18,8,35,43,31,13,6,13,16,116,13
22000637,DEN,1610612743,48,91,0.527,14,34,0.411764706,0.778,34,57,0.596491228,Nuggets,Denver,265,21,27,9,34,43,29,10,3,13,22,131,4
22000637,CHI,1610612741,47,90,0.522,17,35,0.485714286,0.696,30,55,0.545454545,Bulls,Chicago,265,16,23,9,33,42,32,6,2,16,20,127,-4
22000638,PHX,1610612756,43,86,0.5,14,27,0.518518519,0.765,29,59,0.491525424,Suns,Phoenix,240,13,17,6,34,40,29,8,1,18,19,113,12
22000638,MIN,1610612750,37,79,0.468,13,35,0.371428571,0.778,24,44,0.545454545,Timberwolves,Minnesota,240,14,18,5,34,39,22,8,6,19,19,101,-12
22000639,POR,1610612757,44,93,0.473,22,47,0.468085106,0.882,22,46,0.47826087,Trail Blazers,Portland,240,15,17,13,30,43,17,5,0,6,15,125,6
22000639,DAL,1610612742,44,81,0.543,19,42,0.452380952,0.923,25,39,0.641025641,Mavericks,Dallas,240,12,13,5,34,39,25,4,4,12,16,119,-6
22000640,LAL,1610612747,34,81,0.42,8,26,0.307692308,0.75,26,55,0.472727273,Lakers,Los Angeles,240,18,24,13,39,52,18,6,3,16,16,94,-5
22000640,ATL,1610612737,39,98,0.398,13,37,0.351351351,0.889,26,61,0.426229508,Hawks,Atlanta,240,8,9,16,33,49,26,13,7,8,21,99,5
22000641,SAC,1610612758,39,85,0.459,10,28,0.357142857,0.63,29,57,0.50877193,Kings,Sacramento,240,17,27,4,29,33,28,4,2,8,21,105,-24
22000641,PHI,1610612755,48,86,0.558,11,23,0.47826087,0.759,37,63,0.587301587,76ers,Philadelphia,240,22,29,9,43,52,24,7,3,10,22,129,24
22000642,MEM,1610612763,37,95,0.389,10,32,0.3125,0.871,27,63,0.428571429,Grizzlies,Memphis,240,27,31,13,47,60,25,8,5,12,22,111,8
22000642,GSW,1610612744,31,90,0.344,13,41,0.317073171,0.824,18,49,0.367346939,Warriors,Golden State,240,28,34,7,39,46,23,8,7,11,25,103,-8
22000643,SAS,1610612759,46,96,0.479,12,33,0.363636364,0.9,34,63,0.53968254,Spurs,San Antonio,240,9,10,5,36,41,29,6,4,9,11,113,-7
22000643,MIL,1610612749,45,92,0.489,14,38,0.368421053,0.889,31,54,0.574074074,Bucks,Milwaukee,240,16,18,6,43,49,24,5,3,11,11,120,7
22000644,LAC,1610612746,45,86,0.523,12,34,0.352941176,1,33,52,0.634615385,Clippers,LA,240,23,23,9,33,42,26,9,1,9,25,125,27
22000644,CHA,1610612766,31,80,0.388,15,41,0.365853659,0.75,16,39,0.41025641,Hornets,Charlotte,240,21,28,13,26,39,25,5,4,14,20,98,-27
22000645,MIA,1610612748,39,97,0.402,9,37,0.243243243,0.826,30,60,0.5,Heat,Miami,265,19,23,13,38,51,27,7,7,14,19,106,-3
22000645,IND,1610612754,38,98,0.388,15,45,0.333333333,0.9,23,53,0.433962264,Pacers,Indiana,265,18,20,13,37,50,27,8,10,14,22,109,3
22000646,NOP,1610612740,41,85,0.482,8,28,0.285714286,0.767,33,57,0.578947368,Pelicans,New Orleans,240,23,30,14,31,45,26,8,7,16,12,113,5
22000646,DEN,1610612743,44,88,0.5,12,34,0.352941176,0.8,32,54,0.592592593,Nuggets,Denver,240,8,10,10,27,37,30,9,5,15,28,108,-5
22000647,WAS,1610612764,42,79,0.532,7,21,0.333333333,0.789,35,58,0.603448276,Wizards,Washington,240,15,19,10,33,43,24,5,4,19,22,106,-7
22000647,BKN,1610612751,44,90,0.489,9,29,0.310344828,0.727,35,61,0.573770492,Nets,Brooklyn,240,16,22,10,25,35,24,11,8,7,18,113,7
22000648,TOR,1610612761,37,95,0.389,15,46,0.326086957,0.842,22,49,0.448979592,Raptors,Toronto,240,16,19,9,28,37,19,13,3,14,26,105,-11
22000648,CLE,1610612739,39,77,0.506,17,33,0.515151515,0.75,22,44,0.5,Cavaliers,Cleveland,240,21,28,7,47,54,29,8,4,26,19,116,11
22000649,DET,1610612765,32,82,0.39,4,25,0.16,0.72,28,57,0.49122807,Pistons,Detroit,240,18,25,8,29,37,20,11,5,14,16,86,-14
22000649,CHI,1610612741,37,80,0.463,14,28,0.5,0.857,23,52,0.442307692,Bulls,Chicago,240,12,14,9,43,52,26,8,8,18,22,100,14
22000650,PHI,1610612755,38,82,0.463,11,25,0.44,0.609,27,57,0.473684211,76ers,Philadelphia,265,14,23,8,36,44,19,12,9,19,18,101,1
22000650,NYK,1610612752,38,88,0.432,11,24,0.458333333,0.565,27,64,0.421875,Knicks,New York,265,13,23,13,31,44,16,13,2,17,19,100,-1
22000651,PHX,1610612756,42,87,0.483,9,32,0.28125,0.783,33,55,0.6,Suns,Phoenix,240,18,23,9,42,51,30,7,6,10,24,111,17
22000651,LAL,1610612747,35,85,0.412,5,25,0.2,0.679,30,60,0.5,Lakers,Los Angeles,240,19,28,7,34,41,20,3,2,11,18,94,-17
22000652,POR,1610612757,34,89,0.382,9,41,0.219512195,0.789,25,48,0.520833333,Trail Blazers,Portland,240,15,19,9,24,33,17,7,3,6,17,92,-40
22000652,DAL,1610612742,48,86,0.558,19,37,0.513513514,0.85,29,49,0.591836735,Mavericks,Dallas,240,17,20,8,44,52,23,4,3,10,17,132,40
22000653,SAC,1610612758,49,90,0.544,13,30,0.433333333,0.667,36,60,0.6,Kings,Sacramento,240,8,12,10,39,49,26,6,7,16,17,119,14
22000653,CLE,1610612739,41,96,0.427,4,17,0.235294118,0.826,37,79,0.46835443,Cavaliers,Cleveland,240,19,23,10,29,39,22,13,4,8,11,105,-14
22000654,OKC,1610612760,41,87,0.471,21,37,0.567567568,0.9,20,50,0.4,Thunder,Oklahoma City,240,9,10,9,38,47,27,8,10,14,14,112,9
22000654,MIN,1610612750,38,92,0.413,14,39,0.358974359,0.722,24,53,0.452830189,Timberwolves,Minnesota,240,13,18,11,31,42,24,11,4,12,17,103,-9
22000655,SAS,1610612759,36,78,0.462,11,32,0.34375,0.824,25,46,0.543478261,Spurs,San Antonio,240,14,17,5,33,38,17,5,9,14,22,97,-3
22000655,CHA,1610612766,34,81,0.42,12,32,0.375,0.87,22,49,0.448979592,Hornets,Charlotte,240,20,23,7,33,40,27,5,7,11,14,100,3
22000656,UTA,1610612762,45,92,0.489,17,39,0.435897436,0.867,28,53,0.528301887,Jazz,Utah,240,13,15,10,36,46,25,9,10,9,16,120,25
22000656,CHI,1610612741,39,96,0.406,6,26,0.230769231,0.917,33,70,0.471428571,Bulls,Chicago,240,11,12,14,35,49,21,5,3,13,14,95,-25
22000657,TOR,1610612761,37,87,0.425,10,40,0.25,0.789,27,47,0.574468085,Raptors,Toronto,240,15,19,8,36,44,19,6,5,13,24,99,-18
22000657,HOU,1610612745,41,90,0.456,14,36,0.388888889,0.808,27,54,0.5,Rockets,Houston,240,21,26,10,37,47,28,7,7,11,21,117,18
22000658,MEM,1610612763,55,110,0.5,12,35,0.342857143,0.667,43,75,0.573333333,Grizzlies,Memphis,265,10,15,17,37,54,38,8,6,10,20,132,6
22000658,BOS,1610612738,47,90,0.522,17,35,0.485714286,0.625,30,55,0.545454545,Celtics,Boston,265,15,24,5,38,43,31,3,6,12,18,126,-6
22000659,MIL,1610612749,53,94,0.564,24,39,0.615384615,0.667,29,55,0.527272727,Bucks,Milwaukee,240,10,15,8,47,55,35,3,5,15,16,140,27
22000659,IND,1610612754,45,111,0.405,12,50,0.24,0.917,33,61,0.540983607,Pacers,Indiana,240,11,12,11,29,40,27,8,3,6,16,113,-27
22000660,LAC,1610612746,42,85,0.494,17,38,0.447368421,0.9,25,47,0.531914894,Clippers,LA,240,18,20,8,36,44,26,4,7,8,16,119,9
22000660,ATL,1610612737,43,95,0.453,12,34,0.352941176,0.75,31,61,0.508196721,Hawks,Atlanta,240,12,16,15,33,48,21,3,3,7,18,110,-9
22000661,ORL,1610612753,39,88,0.443,11,34,0.323529412,0.714,28,54,0.518518519,Magic,Orlando,240,10,14,9,28,37,27,8,4,13,12,99,-11
22000661,DEN,1610612743,45,91,0.495,8,30,0.266666667,0.923,37,61,0.606557377,Nuggets,Denver,240,12,13,13,39,52,25,12,7,10,13,110,11
22000662,WAS,1610612764,38,79,0.481,9,23,0.391304348,0.8,29,56,0.517857143,Wizards,Washington,240,28,35,7,31,38,25,5,5,16,23,113,-18
22000662,NYK,1610612752,47,92,0.511,16,30,0.533333333,0.875,31,62,0.5,Knicks,New York,240,21,24,12,30,42,23,6,8,10,28,131,18
22000663,NOP,1610612740,47,90,0.522,10,29,0.344827586,0.923,37,61,0.606557377,Pelicans,New Orleans,240,24,26,11,42,53,28,9,3,13,24,128,17
22000663,LAL,1610612747,36,85,0.424,18,37,0.486486486,0.7,18,48,0.375,Lakers,Los Angeles,240,21,30,6,28,34,25,10,4,13,17,111,-17
22000664,PHX,1610612756,45,91,0.495,12,37,0.324324324,0.889,33,54,0.611111111,Suns,Phoenix,240,8,9,8,31,39,29,5,6,6,18,110,10
22000664,MIA,1610612748,36,86,0.419,13,36,0.361111111,0.882,23,50,0.46,Heat,Miami,240,15,17,17,33,50,23,3,4,13,13,100,-10
22000665,PHI,1610612755,39,86,0.453,7,24,0.291666667,0.657,32,62,0.516129032,76ers,Philadelphia,240,23,35,13,38,51,15,5,4,13,24,108,10
22000665,GSW,1610612744,36,83,0.434,8,25,0.32,0.692,28,58,0.482758621,Warriors,Golden State,240,18,26,6,32,38,22,5,7,11,23,98,-10
22000666,POR,1610612757,36,90,0.4,19,55,0.345454545,0.913,17,35,0.485714286,Trail Blazers,Portland,240,21,23,13,31,44,25,4,5,8,20,112,-4
22000666,BKN,1610612751,43,87,0.494,9,30,0.3,0.778,34,57,0.596491228,Nets,Brooklyn,240,21,27,10,37,47,25,5,2,8,17,116,4
22000667,IND,1610612754,45,97,0.464,15,34,0.441176471,0.786,30,63,0.476190476,Pacers,Indiana,240,11,14,11,26,37,25,7,8,10,20,116,5
22000667,DET,1610612765,44,83,0.53,11,28,0.392857143,0.632,33,55,0.6,Pistons,Detroit,240,12,19,5,36,41,29,8,9,15,18,111,-5
22000668,TOR,1610612761,45,89,0.506,24,48,0.5,0.913,21,41,0.512195122,Raptors,Toronto,240,21,23,9,36,45,31,3,6,9,21,135,24
22000668,DEN,1610612743,41,98,0.418,14,43,0.325581395,0.833,27,55,0.490909091,Nuggets,Denver,240,15,18,17,29,46,25,5,2,11,19,111,-24
22000669,MIL,1610612749,45,90,0.5,17,37,0.459459459,0.7,28,53,0.528301887,Bucks,Milwaukee,240,14,20,13,33,46,19,8,5,16,14,121,2
22000669,BOS,1610612738,45,94,0.479,19,47,0.404255319,1,26,47,0.553191489,Celtics,Boston,240,10,10,9,29,38,24,9,6,12,15,119,-2
22000670,PHX,1610612756,40,90,0.444,11,33,0.333333333,0.909,29,57,0.50877193,Suns,Phoenix,240,20,22,10,37,47,22,9,3,8,15,111,-1
22000670,ORL,1610612753,42,90,0.467,13,37,0.351351351,0.789,29,53,0.547169811,Magic,Orlando,240,15,19,9,40,49,18,3,5,11,18,112,1
22000671,CLE,1610612739,42,92,0.457,11,29,0.379310345,0.8,31,63,0.492063492,Cavaliers,Cleveland,240,8,10,12,34,46,28,8,7,10,16,103,9
22000671,CHI,1610612741,37,83,0.446,8,28,0.285714286,0.857,29,55,0.527272727,Bulls,Chicago,240,12,14,10,35,45,21,6,4,15,12,94,-9
22000672,HOU,1610612745,33,86,0.384,16,49,0.326530612,0.682,17,37,0.459459459,Rockets,Houston,240,15,22,10,29,39,24,6,2,6,19,97,-25
22000672,CHA,1610612766,41,80,0.512,18,38,0.473684211,0.759,23,42,0.547619048,Hornets,Charlotte,240,22,29,10,40,50,27,4,3,13,20,122,25
22000673,MIN,1610612750,38,86,0.442,12,38,0.315789474,0.769,26,48,0.541666667,Timberwolves,Minnesota,240,20,26,6,31,37,24,6,2,12,25,108,-20
22000673,DAL,1610612742,48,99,0.485,16,44,0.363636364,0.727,32,55,0.581818182,Mavericks,Dallas,240,16,22,14,39,53,27,5,6,10,22,128,20
22000674,OKC,1610612760,43,95,0.453,10,35,0.285714286,0.647,33,60,0.55,Thunder,Oklahoma City,240,11,17,9,35,44,26,13,8,14,10,107,-9
22000674,MEM,1610612763,47,99,0.475,11,30,0.366666667,0.846,36,69,0.52173913,Grizzlies,Memphis,240,11,13,14,42,56,19,12,10,17,10,116,9
22000675,SAS,1610612759,39,85,0.459,7,22,0.318181818,0.842,32,63,0.507936508,Spurs,San Antonio,240,16,19,6,34,40,22,6,6,16,24,101,-33
22000675,LAC,1610612746,49,88,0.557,17,33,0.515151515,0.633,32,55,0.581818182,Clippers,LA,240,19,30,5,39,44,23,10,3,8,20,134,33
22000676,UTA,1610612762,41,91,0.451,23,55,0.418181818,0.929,18,36,0.5,Jazz,Utah,240,13,14,11,45,56,24,6,6,11,15,118,30
22000676,BKN,1610612751,35,97,0.361,7,35,0.2,0.733,28,62,0.451612903,Nets,Brooklyn,240,11,15,13,35,48,19,9,1,9,10,88,-30
22000677,SAC,1610612758,40,84,0.476,10,30,0.333333333,0.909,30,54,0.555555556,Kings,Sacramento,240,20,22,12,30,42,21,5,6,16,16,110,2
22000677,ATL,1610612737,41,85,0.482,7,25,0.28,0.826,34,60,0.566666667,Hawks,Atlanta,240,19,23,11,31,42,17,5,3,13,20,108,-2
22000678,POR,1610612757,44,92,0.478,20,46,0.434782609,0.895,24,46,0.52173913,Trail Blazers,Portland,240,17,19,10,30,40,24,3,7,10,14,125,3
22000678,MIA,1610612748,47,84,0.56,16,34,0.470588235,0.923,31,50,0.62,Heat,Miami,240,12,13,5,34,39,34,3,7,11,18,122,-3
22000679,WAS,1610612764,37,80,0.463,8,26,0.307692308,0.606,29,54,0.537037037,Wizards,Washington,240,20,33,8,38,46,26,8,9,17,32,102,-4
22000679,NYK,1610612752,34,93,0.366,7,28,0.25,0.738,27,65,0.415384615,Knicks,New York,240,31,42,18,37,55,14,12,4,13,28,106,4
22000680,SAS,1610612759,33,82,0.402,8,23,0.347826087,0.846,25,59,0.423728814,Spurs,San Antonio,240,11,13,2,37,39,16,4,6,7,14,85,-13
22000680,LAC,1610612746,34,89,0.382,13,34,0.382352941,0.944,21,55,0.381818182,Clippers,LA,240,17,18,14,43,57,16,6,5,8,13,98,13
22000681,PHI,1610612755,39,80,0.487,17,45,0.377777778,0.667,22,35,0.628571429,76ers,Philadelphia,240,14,21,7,32,39,24,13,9,20,26,109,8
22000681,LAL,1610612747,34,78,0.436,9,26,0.346153846,0.727,25,52,0.480769231,Lakers,Los Angeles,240,24,33,7,35,42,22,10,0,20,19,101,-8
22000682,SAC,1610612758,53,89,0.596,19,38,0.5,0.842,34,51,0.666666667,Kings,Sacramento,240,16,19,5,33,38,28,6,4,6,13,141,22
22000682,GSW,1610612744,45,88,0.511,17,32,0.53125,1,28,56,0.5,Warriors,Golden State,240,12,12,7,31,38,24,4,0,12,19,119,-22
22000683,DET,1610612765,33,73,0.452,11,31,0.35483871,0.723,22,42,0.523809524,Pistons,Detroit,240,34,47,7,29,36,19,6,4,9,30,111,-2
22000683,BKN,1610612751,37,84,0.44,13,33,0.393939394,0.765,24,51,0.470588235,Nets,Brooklyn,240,26,34,16,33,49,19,3,4,10,27,113,2
22000684,TOR,1610612761,37,90,0.411,12,45,0.266666667,0.875,25,45,0.555555556,Raptors,Toronto,240,14,16,7,31,38,20,5,4,10,17,100,-4
22000684,PHX,1610612756,43,90,0.478,9,36,0.25,1,34,54,0.62962963,Suns,Phoenix,240,9,9,9,38,47,26,4,3,13,16,104,4
22000685,MIL,1610612749,44,99,0.444,19,47,0.404255319,0.636,25,52,0.480769231,Bucks,Milwaukee,240,7,11,16,33,49,24,7,3,16,16,114,-8
22000685,BOS,1610612738,43,88,0.489,22,47,0.468085106,0.875,21,41,0.512195122,Celtics,Boston,240,14,16,8,36,44,27,10,8,14,16,122,8
22000686,MIA,1610612748,40,87,0.46,15,43,0.348837209,0.5,25,44,0.568181818,Heat,Miami,240,10,20,9,30,39,28,9,3,10,17,105,-5
22000686,CHA,1610612766,39,79,0.494,18,43,0.418604651,0.737,21,36,0.583333333,Hornets,Charlotte,240,14,19,6,36,42,30,6,7,16,16,110,5
22000687,POR,1610612757,40,85,0.471,18,40,0.45,0.667,22,45,0.488888889,Trail Blazers,Portland,240,14,21,10,36,46,21,7,9,16,18,112,7
22000687,ORL,1610612753,42,95,0.442,12,27,0.444444444,0.529,30,68,0.441176471,Magic,Orlando,240,9,17,11,29,40,29,7,5,12,18,105,-7
22000688,MIN,1610612750,39,103,0.379,10,38,0.263157895,0.792,29,65,0.446153846,Timberwolves,Minnesota,240,19,24,14,36,50,30,12,3,9,13,107,6
22000688,HOU,1610612745,37,87,0.425,17,44,0.386363636,0.769,20,43,0.465116279,Rockets,Houston,240,10,13,7,40,47,26,5,9,19,20,101,-6
22000689,NOP,1610612740,39,78,0.5,12,29,0.413793103,0.9,27,49,0.551020408,Pelicans,New Orleans,240,18,20,6,31,37,30,7,7,12,11,108,-5
22000689,DEN,1610612743,47,93,0.505,14,28,0.5,0.714,33,65,0.507692308,Nuggets,Denver,240,5,7,11,25,36,28,7,7,8,16,113,5
22000690,IND,1610612754,38,87,0.437,20,47,0.425531915,0.722,18,40,0.45,Pacers,Indiana,240,13,18,13,36,49,26,9,10,10,17,109,15
22000690,DAL,1610612742,39,95,0.411,8,35,0.228571429,0.571,31,60,0.516666667,Mavericks,Dallas,240,8,14,15,36,51,17,4,4,15,18,94,-15
22000691,UTA,1610612762,45,98,0.459,12,33,0.363636364,0.833,33,65,0.507692308,Jazz,Utah,240,15,18,14,37,51,25,5,4,7,15,117,3
22000691,MEM,1610612763,44,97,0.454,12,30,0.4,0.778,32,67,0.47761194,Grizzlies,Memphis,240,14,18,12,36,48,27,3,2,6,14,114,-3
22000692,GSW,1610612744,39,79,0.494,12,28,0.428571429,0.692,27,51,0.529411765,Warriors,Golden State,240,18,26,5,28,33,29,7,4,12,22,108,-16
22000692,ATL,1610612737,46,84,0.548,13,33,0.393939394,0.792,33,51,0.647058824,Hawks,Atlanta,240,19,24,8,37,45,31,6,5,10,23,124,16
22000693,LAL,1610612747,38,78,0.487,6,26,0.230769231,0.72,32,52,0.615384615,Lakers,Los Angeles,240,18,25,9,36,45,23,15,3,23,23,100,14
22000693,CLE,1610612739,31,80,0.388,5,26,0.192307692,0.679,26,54,0.481481481,Cavaliers,Cleveland,240,19,28,10,27,37,24,11,4,21,19,86,-14
22000694,WAS,1610612764,44,91,0.484,9,21,0.428571429,1,35,70,0.5,Wizards,Washington,240,9,9,7,41,48,24,7,5,18,22,106,14
22000694,DET,1610612765,33,85,0.388,10,29,0.344827586,0.842,23,56,0.410714286,Pistons,Detroit,240,16,19,7,36,43,19,9,5,19,18,92,-14
22000695,NYK,1610612752,40,93,0.43,16,44,0.363636364,0.75,24,49,0.489795918,Knicks,New York,240,6,8,12,32,44,28,9,11,14,19,102,6
22000695,MIL,1610612749,36,87,0.414,14,36,0.388888889,0.625,22,51,0.431372549,Bucks,Milwaukee,240,10,16,15,33,48,21,11,7,16,11,96,-6
22000696,MIN,1610612750,36,85,0.424,13,40,0.325,0.786,23,45,0.511111111,Timberwolves,Minnesota,240,22,28,10,30,40,26,8,6,11,15,107,-22
22000696,HOU,1610612745,50,92,0.543,18,39,0.461538462,0.846,32,53,0.603773585,Rockets,Houston,240,11,13,10,31,41,29,7,7,12,24,129,22
22000697,SAS,1610612759,46,85,0.541,10,25,0.4,0.643,36,60,0.6,Spurs,San Antonio,240,18,28,4,37,41,29,9,7,10,15,120,16
22000697,CHI,1610612741,41,95,0.432,8,34,0.235294118,0.778,33,61,0.540983607,Bulls,Chicago,240,14,18,11,37,48,28,6,3,14,25,104,-16
22000698,NOP,1610612740,42,81,0.519,9,26,0.346153846,0.655,33,55,0.6,Pelicans,New Orleans,240,19,29,8,34,42,20,2,5,6,18,112,9
22000698,DAL,1610612742,37,83,0.446,10,31,0.322580645,0.792,27,52,0.519230769,Mavericks,Dallas,240,19,24,10,28,38,19,2,4,7,20,103,-9
22000699,OKC,1610612760,34,83,0.41,11,38,0.289473684,0.625,23,45,0.511111111,Thunder,Oklahoma City,240,15,24,10,40,50,16,7,4,16,12,94,-17
22000699,BOS,1610612738,44,96,0.458,12,38,0.315789474,0.786,32,58,0.551724138,Celtics,Boston,240,11,14,10,42,52,22,10,4,12,19,111,17
22000700,UTA,1610612762,46,92,0.5,19,45,0.422222222,0.75,27,47,0.574468085,Jazz,Utah,240,15,20,13,39,52,22,8,8,21,22,126,16
22000700,MEM,1610612763,39,97,0.402,9,33,0.272727273,0.767,30,64,0.46875,Grizzlies,Memphis,240,23,30,16,31,47,24,16,2,14,14,110,-16
22000701,PHI,1610612755,39,77,0.506,10,26,0.384615385,0.727,29,51,0.568627451,76ers,Philadelphia,240,24,33,8,30,38,17,5,2,16,27,112,-10
22000701,LAC,1610612746,45,85,0.529,11,26,0.423076923,0.778,34,59,0.576271186,Clippers,LA,240,21,27,9,29,38,26,9,3,12,25,122,10
22000702,SAC,1610612758,41,80,0.512,7,30,0.233333333,0.786,34,50,0.68,Kings,Sacramento,240,11,14,7,37,44,16,4,9,18,20,100,2
22000702,CLE,1610612739,37,84,0.44,9,26,0.346153846,0.652,28,58,0.482758621,Cavaliers,Cleveland,240,15,23,7,29,36,20,11,2,7,13,98,-2
22000703,PHX,1610612756,34,96,0.354,8,40,0.2,0.862,26,56,0.464285714,Suns,Phoenix,265,25,29,21,29,50,17,15,2,14,17,101,4
22000703,CHA,1610612766,34,85,0.4,13,43,0.302325581,0.696,21,42,0.5,Hornets,Charlotte,265,16,23,16,36,52,16,8,3,20,23,97,-4
22000704,TOR,1610612761,39,87,0.448,14,42,0.333333333,0.758,25,45,0.555555556,Raptors,Toronto,240,25,33,12,33,45,17,3,6,12,20,117,-5
22000704,POR,1610612757,46,97,0.474,10,34,0.294117647,0.833,36,63,0.571428571,Trail Blazers,Portland,240,20,24,13,34,47,24,7,11,8,25,122,5
22000705,DEN,1610612743,50,92,0.543,15,36,0.416666667,0.688,35,56,0.625,Nuggets,Denver,240,11,16,15,34,49,32,7,3,10,15,126,24
22000705,ATL,1610612737,36,76,0.474,12,34,0.352941176,0.857,24,42,0.571428571,Hawks,Atlanta,240,18,21,2,29,31,18,7,3,11,16,102,-24
22000706,ORL,1610612753,34,88,0.386,11,33,0.333333333,0.824,23,55,0.418181818,Magic,Orlando,240,14,17,10,41,51,19,5,4,10,18,93,-3
22000706,LAL,1610612747,34,82,0.415,11,40,0.275,0.739,23,42,0.547619048,Lakers,Los Angeles,240,17,23,8,44,52,25,9,5,12,17,96,3
22000707,WAS,1610612764,55,99,0.556,10,19,0.526315789,0.667,45,80,0.5625,Wizards,Washington,240,12,18,12,43,55,30,5,8,18,24,132,8
22000707,IND,1610612754,44,93,0.473,12,30,0.4,0.727,32,63,0.507936508,Pacers,Indiana,240,24,33,7,30,37,32,11,6,14,18,124,-8
22000708,NOP,1610612740,41,82,0.5,16,31,0.516129032,0.567,25,51,0.490196078,Pelicans,New Orleans,240,17,30,8,39,47,30,8,2,14,21,115,6
22000708,BOS,1610612738,40,93,0.43,14,43,0.325581395,0.789,26,50,0.52,Celtics,Boston,240,15,19,12,34,46,21,5,9,14,25,109,-6
22000709,MIN,1610612750,40,103,0.388,14,44,0.318181818,0.765,26,59,0.440677966,Timberwolves,Minnesota,240,13,17,17,34,51,23,10,10,15,25,107,-5
22000709,BKN,1610612751,40,85,0.471,10,30,0.333333333,0.88,30,55,0.545454545,Nets,Brooklyn,240,22,25,7,43,50,31,10,7,14,18,112,5
22000710,NYK,1610612752,33,80,0.412,10,36,0.277777778,0.6,23,44,0.522727273,Knicks,New York,240,12,20,6,35,41,15,4,6,13,19,88,-10
22000710,MIA,1610612748,37,86,0.43,10,34,0.294117647,0.824,27,52,0.519230769,Heat,Miami,240,14,17,12,35,47,22,7,5,12,18,98,10
22000711,TOR,1610612761,35,86,0.407,11,36,0.305555556,0.821,24,50,0.48,Raptors,Toronto,240,23,28,11,28,39,21,5,6,13,25,104,-14
22000711,DET,1610612765,38,75,0.507,15,30,0.5,0.794,23,45,0.511111111,Pistons,Detroit,240,27,34,9,34,43,26,6,6,18,24,118,14
22000712,MEM,1610612763,46,85,0.541,11,31,0.35483871,0.708,35,54,0.648148148,Grizzlies,Memphis,240,17,24,7,40,47,31,8,4,16,18,120,10
22000712,HOU,1610612745,40,94,0.426,11,42,0.261904762,0.864,29,52,0.557692308,Rockets,Houston,240,19,22,10,32,42,28,9,5,12,18,110,-10
22000713,OKC,1610612760,38,81,0.469,9,26,0.346153846,0.636,29,55,0.527272727,Thunder,Oklahoma City,240,21,33,10,37,47,17,8,4,16,14,106,-21
22000713,DAL,1610612742,51,96,0.531,16,44,0.363636364,0.692,35,52,0.673076923,Mavericks,Dallas,240,9,13,8,35,43,30,11,3,8,21,127,21
22000714,SAS,1610612759,47,93,0.505,10,27,0.37037037,0.786,37,66,0.560606061,Spurs,San Antonio,240,11,14,12,29,41,24,5,4,11,18,115,-17
22000714,SAC,1610612758,47,84,0.56,18,36,0.5,0.8,29,48,0.604166667,Kings,Sacramento,240,20,25,4,33,37,29,9,6,6,15,132,17
22000715,UTA,1610612762,38,82,0.463,19,41,0.463414634,0.826,19,41,0.463414634,Jazz,Utah,240,19,23,9,46,55,29,6,5,12,14,114,39
22000715,CLE,1610612739,29,83,0.349,7,34,0.205882353,0.625,22,49,0.448979592,Cavaliers,Cleveland,240,10,16,6,34,40,17,5,5,10,18,75,-39
22000716,GSW,1610612744,46,92,0.5,16,38,0.421052632,0.889,30,54,0.555555556,Warriors,Golden State,240,8,9,10,29,39,28,9,8,14,14,116,14
22000716,CHI,1610612741,44,84,0.524,6,24,0.25,0.727,38,60,0.633333333,Bulls,Chicago,240,8,11,8,31,39,33,8,5,19,18,102,-14
22000717,MIL,1610612749,38,81,0.469,11,30,0.366666667,0.857,27,51,0.529411765,Bucks,Milwaukee,240,18,21,5,27,32,18,8,4,12,14,105,-24
22000717,LAC,1610612746,51,95,0.537,19,34,0.558823529,0.8,32,61,0.524590164,Clippers,LA,240,8,10,13,33,46,25,5,2,12,15,129,24
22000718,WAS,1610612764,41,100,0.41,10,37,0.27027027,0.8,31,63,0.492063492,Wizards,Washington,240,12,15,15,36,51,22,5,1,13,19,104,-10
22000718,CHA,1610612766,42,90,0.467,14,34,0.411764706,0.842,28,56,0.5,Hornets,Charlotte,240,16,19,9,41,50,24,6,6,14,17,114,10
22000719,PHI,1610612755,35,82,0.427,11,35,0.314285714,0.933,24,47,0.510638298,76ers,Philadelphia,240,14,15,5,29,34,18,14,6,11,18,95,-9
22000719,DEN,1610612743,39,81,0.481,12,31,0.387096774,0.824,27,50,0.54,Nuggets,Denver,240,14,17,9,42,51,26,9,6,20,16,104,9
22000720,ORL,1610612753,38,92,0.413,5,17,0.294117647,0.88,33,75,0.44,Magic,Orlando,240,22,25,15,35,50,23,10,6,8,13,103,7
22000720,LAC,1610612746,37,89,0.416,12,37,0.324324324,1,25,52,0.480769231,Clippers,LA,240,10,10,12,36,48,25,3,4,14,21,96,-7
22000721,POR,1610612757,42,82,0.512,16,30,0.533333333,0.923,26,52,0.5,Trail Blazers,Portland,240,24,26,6,37,43,27,11,7,13,20,124,23
22000721,DET,1610612765,40,86,0.465,9,27,0.333333333,0.706,31,59,0.525423729,Pistons,Detroit,240,12,17,5,31,36,29,7,7,16,26,101,-23
22000722,MIA,1610612748,32,78,0.41,10,32,0.3125,0.643,22,46,0.47826087,Heat,Miami,240,18,28,8,34,42,22,5,4,11,14,92,5
22000722,IND,1610612754,34,85,0.4,11,37,0.297297297,0.667,23,48,0.479166667,Pacers,Indiana,240,8,12,11,37,48,23,7,4,13,23,87,-5
22000723,DAL,1610612742,38,77,0.494,19,39,0.487179487,0.72,19,38,0.5,Mavericks,Dallas,240,18,25,4,39,43,20,6,4,16,18,113,5
22000723,BOS,1610612738,39,94,0.415,11,47,0.234042553,0.826,28,47,0.595744681,Celtics,Boston,240,19,23,8,28,36,20,11,2,9,19,108,-5
22000724,HOU,1610612745,39,78,0.5,13,40,0.325,0.708,26,38,0.684210526,Rockets,Houston,240,17,24,6,25,31,22,5,8,13,21,108,-12
22000724,BKN,1610612751,44,90,0.489,13,36,0.361111111,1,31,54,0.574074074,Nets,Brooklyn,240,19,19,12,33,45,25,6,3,11,21,120,12
22000725,UTA,1610612762,38,89,0.427,16,49,0.326530612,0.76,22,40,0.55,Jazz,Utah,240,19,25,11,35,46,20,10,5,14,21,111,4
22000725,MEM,1610612763,42,90,0.467,5,18,0.277777778,0.783,37,72,0.513888889,Grizzlies,Memphis,240,18,23,11,35,46,23,10,4,11,20,107,-4
22000726,NYK,1610612752,39,82,0.476,11,23,0.47826087,0.706,28,59,0.474576271,Knicks,New York,240,12,17,7,34,41,20,7,6,16,18,101,-1
22000726,MIN,1610612750,36,87,0.414,14,40,0.35,0.842,22,47,0.468085106,Timberwolves,Minnesota,240,16,19,9,31,40,25,9,8,12,14,102,1
22000727,TOR,1610612761,35,90,0.389,16,46,0.347826087,0.85,19,44,0.431818182,Raptors,Toronto,240,17,20,7,28,35,21,13,7,7,25,103,-10
22000727,OKC,1610612760,39,86,0.453,14,33,0.424242424,0.75,25,53,0.471698113,Thunder,Oklahoma City,240,21,28,19,45,64,19,2,6,18,16,113,10
22000728,SAS,1610612759,43,92,0.467,10,26,0.384615385,0.706,33,66,0.5,Spurs,San Antonio,240,24,34,14,40,54,24,9,2,10,17,120,14
22000728,SAC,1610612758,39,92,0.424,11,35,0.314285714,0.895,28,57,0.49122807,Kings,Sacramento,240,17,19,11,32,43,22,7,5,12,20,106,-14
22000729,MIL,1610612749,42,79,0.532,14,26,0.538461538,0.778,28,53,0.528301887,Bucks,Milwaukee,240,14,18,7,35,42,23,13,8,21,17,112,15
22000729,LAL,1610612747,35,87,0.402,10,36,0.277777778,0.773,25,51,0.490196078,Lakers,Los Angeles,240,17,22,11,29,40,22,9,5,22,22,97,-15
22000730,PHX,1610612756,46,81,0.568,11,25,0.44,0.75,35,56,0.625,Suns,Phoenix,240,18,24,4,28,32,29,6,7,9,21,121,5
22000730,CHI,1610612741,43,99,0.434,11,33,0.333333333,0.905,32,66,0.484848485,Bulls,Chicago,240,19,21,18,32,50,27,6,4,9,20,116,-5
22000731,PHI,1610612755,40,93,0.43,15,37,0.405405405,0.76,25,56,0.446428571,76ers,Philadelphia,240,19,25,12,43,55,27,11,8,9,19,114,20
22000731,CLE,1610612739,34,80,0.425,10,35,0.285714286,0.762,24,45,0.533333333,Cavaliers,Cleveland,240,16,21,4,36,40,26,5,3,18,24,94,-20
22000732,CHA,1610612766,30,86,0.349,13,38,0.342105263,0.842,17,48,0.354166667,Hornets,Charlotte,240,16,19,11,32,43,22,11,5,11,9,89,-22
22000732,BKN,1610612751,44,91,0.484,20,45,0.444444444,0.75,24,46,0.52173913,Nets,Brooklyn,240,3,4,13,43,56,34,8,5,15,18,111,22
22000733,MIA,1610612748,39,82,0.476,13,39,0.333333333,0.833,26,43,0.604651163,Heat,Miami,240,25,30,5,32,37,30,10,6,11,22,116,7
22000733,GSW,1610612744,36,82,0.439,15,37,0.405405405,0.88,21,45,0.466666667,Warriors,Golden State,240,22,25,12,34,46,23,7,3,20,26,109,-7
22000734,ORL,1610612753,45,106,0.425,5,25,0.2,0.87,40,81,0.49382716,Magic,Orlando,265,20,23,12,36,48,20,17,5,10,20,115,5
22000734,NOP,1610612740,41,93,0.441,12,29,0.413793103,0.842,29,64,0.453125,Pelicans,New Orleans,265,16,19,12,43,55,26,7,7,24,23,110,-5
22000735,SAS,1610612759,49,110,0.445,13,40,0.325,0.75,36,70,0.514285714,Spurs,San Antonio,290,18,24,11,35,46,25,8,6,6,22,129,-5
22000735,ATL,1610612737,50,100,0.5,13,24,0.541666667,0.808,37,76,0.486842105,Hawks,Atlanta,290,21,26,10,47,57,28,3,9,12,22,134,5
22000736,LAC,1610612746,35,85,0.412,10,34,0.294117647,0.875,25,51,0.490196078,Clippers,LA,240,14,16,13,32,45,17,6,5,10,19,94,-7
22000736,DEN,1610612743,39,81,0.481,13,25,0.52,0.714,26,56,0.464285714,Nuggets,Denver,240,10,14,7,31,38,28,6,5,13,16,101,7
22000737,TOR,1610612761,47,88,0.534,15,35,0.428571429,0.84,32,53,0.603773585,Raptors,Toronto,240,21,25,10,43,53,26,14,8,12,17,130,53
22000737,GSW,1610612744,26,79,0.329,11,34,0.323529412,0.778,15,45,0.333333333,Warriors,Golden State,240,14,18,7,31,38,19,5,4,21,18,77,-53
22000738,HOU,1610612745,37,86,0.43,12,36,0.333333333,0.615,25,50,0.5,Rockets,Houston,240,16,26,10,30,40,26,6,1,12,11,102,-16
22000738,BOS,1610612738,46,88,0.523,17,41,0.414634146,0.75,29,47,0.617021277,Celtics,Boston,240,9,12,11,39,50,35,9,7,13,22,118,16
22000739,NYK,1610612752,32,89,0.36,12,38,0.315789474,1,20,51,0.392156863,Knicks,New York,240,10,10,9,34,43,18,7,3,11,17,86,-13
22000739,DAL,1610612742,41,88,0.466,12,37,0.324324324,0.5,29,51,0.568627451,Mavericks,Dallas,240,5,10,4,43,47,19,6,2,10,12,99,13
22000740,IND,1610612754,38,82,0.463,10,33,0.303030303,0.579,28,49,0.571428571,Pacers,Indiana,240,11,19,9,39,48,29,7,6,20,21,97,-17
22000740,CHA,1610612766,43,95,0.453,8,31,0.258064516,0.69,35,64,0.546875,Hornets,Charlotte,240,20,29,11,33,44,27,16,3,10,16,114,17
22000741,MIN,1610612750,38,85,0.447,12,33,0.363636364,0.87,26,52,0.5,Timberwolves,Minnesota,240,20,23,5,34,39,21,6,6,11,20,108,-12
22000741,MEM,1610612763,42,95,0.442,19,39,0.487179487,0.68,23,56,0.410714286,Grizzlies,Memphis,240,17,25,14,39,53,26,8,4,10,20,120,12
22000742,NOP,1610612740,38,88,0.432,8,29,0.275862069,0.826,30,59,0.508474576,Pelicans,New Orleans,240,19,23,5,29,34,22,7,6,15,18,103,-23
22000742,ATL,1610612737,49,87,0.563,13,29,0.448275862,0.714,36,58,0.620689655,Hawks,Atlanta,240,15,21,6,36,42,25,10,9,15,23,126,23
22000743,UTA,1610612762,37,79,0.468,13,36,0.361111111,0.963,24,43,0.558139535,Jazz,Utah,240,26,27,6,37,43,16,6,5,10,18,113,7
22000743,CHI,1610612741,43,89,0.483,7,28,0.25,0.765,36,61,0.590163934,Bulls,Chicago,240,13,17,7,34,41,26,5,3,6,19,106,-7
22000744,PHX,1610612756,54,90,0.6,15,33,0.454545455,0.81,39,57,0.684210526,Suns,Phoenix,240,17,21,6,35,41,36,12,8,10,20,140,37
22000744,OKC,1610612760,35,89,0.393,15,38,0.394736842,0.783,20,51,0.392156863,Thunder,Oklahoma City,240,18,23,11,27,38,19,6,3,16,17,103,-37
22000745,POR,1610612757,36,99,0.364,21,54,0.388888889,0.727,15,45,0.333333333,Trail Blazers,Portland,240,16,22,13,32,45,19,11,3,13,18,109,-18
22000745,MIL,1610612749,49,90,0.544,12,39,0.307692308,0.895,37,51,0.725490196,Bucks,Milwaukee,240,17,19,4,46,50,25,7,5,15,18,127,18
22000746,SAC,1610612758,36,85,0.424,10,35,0.285714286,0.75,26,50,0.52,Kings,Sacramento,240,12,16,6,32,38,24,8,5,14,16,94,-21
22000746,LAL,1610612747,43,91,0.473,17,33,0.515151515,0.6,26,58,0.448275862,Lakers,Los Angeles,240,12,20,13,42,55,26,10,2,17,19,115,21
22000747,WAS,1610612764,35,86,0.407,5,25,0.2,0.8,30,61,0.491803279,Wizards,Washington,240,12,15,9,35,44,12,4,3,14,21,87,-22
22000747,DAL,1610612742,40,90,0.444,10,30,0.333333333,0.792,30,60,0.5,Mavericks,Dallas,240,19,24,14,36,50,17,7,4,7,22,109,22
22000748,NYK,1610612752,43,79,0.544,19,39,0.487179487,0.741,24,40,0.6,Knicks,New York,240,20,27,7,37,44,31,12,11,7,18,125,44
22000748,DET,1610612765,29,82,0.354,9,28,0.321428571,0.7,20,54,0.37037037,Pistons,Detroit,240,14,20,12,31,43,20,4,4,14,20,81,-44
22000749,MIA,1610612748,44,82,0.537,15,38,0.394736842,0.75,29,44,0.659090909,Heat,Miami,240,12,16,4,33,37,35,6,3,11,20,115,14
22000749,CLE,1610612739,35,74,0.473,10,31,0.322580645,0.84,25,43,0.581395349,Cavaliers,Cleveland,240,21,25,5,30,35,25,7,4,15,15,101,-14
22000750,PHI,1610612755,41,81,0.506,12,28,0.428571429,0.757,29,53,0.547169811,76ers,Philadelphia,240,28,37,8,34,42,26,7,7,12,24,122,9
22000750,MIN,1610612750,35,78,0.449,12,36,0.333333333,0.861,23,42,0.547619048,Timberwolves,Minnesota,240,31,36,6,30,36,17,7,5,9,24,113,-9
22000751,SAS,1610612759,48,99,0.485,10,29,0.344827586,0.844,38,70,0.542857143,Spurs,San Antonio,265,27,32,18,28,46,22,6,6,17,21,133,-6
22000751,IND,1610612754,52,94,0.553,12,29,0.413793103,0.885,40,65,0.615384615,Pacers,Indiana,265,23,26,11,33,44,27,10,6,13,22,139,6
22000752,UTA,1610612762,51,92,0.554,26,55,0.472727273,0.75,25,37,0.675675676,Jazz,Utah,240,9,12,7,43,50,34,10,6,11,25,137,46
22000752,ORL,1610612753,32,87,0.368,2,23,0.086956522,0.806,30,64,0.46875,Magic,Orlando,240,25,31,9,30,39,11,5,4,10,14,91,-46
22000753,POR,1610612757,51,104,0.49,20,46,0.434782609,0.786,31,58,0.534482759,Trail Blazers,Portland,240,11,14,15,41,56,25,13,3,9,18,133,48
22000753,OKC,1610612760,30,85,0.353,8,34,0.235294118,0.708,22,51,0.431372549,Thunder,Oklahoma City,240,17,24,12,34,46,17,4,6,22,21,85,-48
22000754,SAC,1610612758,49,99,0.495,17,39,0.435897436,1,32,60,0.533333333,Kings,Sacramento,240,13,13,12,28,40,31,7,4,12,17,128,-1
22000754,MIL,1610612749,50,93,0.538,11,31,0.35483871,0.9,39,62,0.629032258,Bucks,Milwaukee,240,18,20,12,35,47,31,10,3,13,15,129,1
22000755,CHI,1610612741,43,78,0.551,8,22,0.363636364,0.7,35,56,0.625,Bulls,Chicago,240,21,30,6,34,40,29,4,3,9,11,115,8
22000755,BKN,1610612751,45,93,0.484,11,28,0.392857143,0.857,34,65,0.523076923,Nets,Brooklyn,240,6,7,4,31,35,28,3,3,5,17,107,-8
22000756,LAL,1610612747,32,80,0.4,7,23,0.304347826,0.75,25,57,0.438596491,Lakers,Los Angeles,240,15,20,7,29,36,16,9,7,18,11,86,-18
22000756,LAC,1610612746,41,86,0.477,14,28,0.5,0.889,27,58,0.465517241,Clippers,LA,240,8,9,13,37,50,23,10,4,19,25,104,18
22000757,CHA,1610612766,32,80,0.4,10,31,0.322580645,0.6,22,49,0.448979592,Hornets,Charlotte,240,12,20,9,33,42,23,3,5,17,15,86,-30
22000757,BOS,1610612738,43,94,0.457,21,54,0.388888889,0.818,22,40,0.55,Celtics,Boston,240,9,11,14,30,44,29,11,5,6,20,116,30
22000758,PHI,1610612755,37,89,0.416,8,34,0.235294118,0.643,29,55,0.527272727,76ers,Philadelphia,240,18,28,16,34,50,23,4,6,10,19,100,-16
22000758,MEM,1610612763,44,89,0.494,16,38,0.421052632,0.8,28,51,0.549019608,Grizzlies,Memphis,240,12,15,10,39,49,30,6,10,12,23,116,16
22000759,GSW,1610612744,43,92,0.467,10,40,0.25,0.714,33,52,0.634615385,Warriors,Golden State,240,15,21,9,36,45,25,12,6,16,26,111,-6
22000759,ATL,1610612737,35,81,0.432,12,32,0.375,0.778,23,49,0.469387755,Hawks,Atlanta,240,35,45,10,39,49,19,10,3,15,19,117,6
22000760,NOP,1610612740,42,91,0.462,16,37,0.432432432,0.629,26,54,0.481481481,Pelicans,New Orleans,240,22,35,16,39,55,26,12,9,15,27,122,7
22000760,HOU,1610612745,41,89,0.461,16,40,0.4,0.708,25,49,0.510204082,Rockets,Houston,240,17,24,9,39,48,25,3,3,17,24,115,-7
22000761,ORL,1610612753,42,89,0.472,13,35,0.371428571,0.706,29,54,0.537037037,Magic,Orlando,240,12,17,10,26,36,27,11,4,11,26,109,-10
22000761,DEN,1610612743,43,88,0.489,9,29,0.310344828,0.774,34,59,0.576271186,Nuggets,Denver,240,24,31,19,35,54,27,6,5,14,14,119,10
22000762,NYK,1610612752,40,86,0.465,14,29,0.482758621,0.818,26,57,0.456140351,Knicks,New York,240,18,22,5,36,41,24,7,4,12,25,112,-2
22000762,BKN,1610612751,42,92,0.457,10,32,0.3125,0.769,32,60,0.533333333,Nets,Brooklyn,240,20,26,11,34,45,27,6,6,10,14,114,2
22000763,WAS,1610612764,37,94,0.394,12,35,0.342857143,0.833,25,59,0.423728814,Wizards,Washington,240,15,18,15,39,54,21,7,5,16,18,101,-2
22000763,TOR,1610612761,44,94,0.468,7,33,0.212121212,0.727,37,61,0.606557377,Raptors,Toronto,240,8,11,6,39,45,22,11,9,13,20,103,2
22000764,UTA,1610612762,37,88,0.42,12,44,0.272727273,0.773,25,44,0.568181818,Jazz,Utah,240,17,22,14,34,48,20,3,4,8,18,103,-8
22000764,DAL,1610612742,41,91,0.451,23,49,0.469387755,0.75,18,42,0.428571429,Mavericks,Dallas,240,6,8,10,34,44,22,2,2,9,18,111,8
22000765,SAC,1610612758,39,88,0.443,9,36,0.25,0.792,30,52,0.576923077,Kings,Sacramento,240,19,24,10,32,42,27,9,8,14,19,106,-10
22000765,MIN,1610612750,38,91,0.418,12,32,0.375,0.848,26,59,0.440677966,Timberwolves,Minnesota,240,28,33,15,36,51,22,10,4,14,16,116,10
22000766,OKC,1610612760,41,97,0.423,5,27,0.185185185,0.84,36,70,0.514285714,Thunder,Oklahoma City,240,21,25,13,29,42,17,10,6,15,20,108,-24
22000766,DET,1610612765,49,95,0.516,13,28,0.464285714,0.875,36,67,0.537313433,Pistons,Detroit,240,21,24,13,37,50,32,10,7,14,20,132,24
22000767,SAS,1610612759,35,83,0.422,5,26,0.192307692,0.813,30,57,0.526315789,Spurs,San Antonio,240,26,32,8,30,38,22,4,3,10,22,101,-24
22000767,CLE,1610612739,45,86,0.523,12,34,0.352941176,0.852,33,52,0.634615385,Cavaliers,Cleveland,240,23,27,7,40,47,29,5,4,6,24,125,24
22000768,PHX,1610612756,44,86,0.512,18,37,0.486486486,0.871,26,49,0.530612245,Suns,Phoenix,240,27,31,6,31,37,29,11,3,11,22,133,3
22000768,HOU,1610612745,43,79,0.544,17,33,0.515151515,0.818,26,46,0.565217391,Rockets,Houston,240,27,33,5,33,38,28,6,3,18,25,130,-3
22000769,IND,1610612754,38,88,0.432,9,30,0.3,0.75,29,58,0.5,Pacers,Indiana,240,12,16,6,27,33,20,15,12,14,17,97,-16
22000769,CHI,1610612741,44,94,0.468,14,33,0.424242424,0.786,30,61,0.491803279,Bulls,Chicago,240,11,14,14,43,57,28,9,5,20,12,113,16
22000770,NOP,1610612740,37,91,0.407,12,38,0.315789474,0.75,25,53,0.471698113,Pelicans,New Orleans,240,21,28,16,33,49,24,7,7,14,15,107,-16
22000770,ATL,1610612737,44,88,0.5,20,31,0.64516129,0.682,24,57,0.421052632,Hawks,Atlanta,240,15,22,10,32,42,24,7,6,11,23,123,16
22000771,PHI,1610612755,34,73,0.466,9,24,0.375,0.744,25,49,0.510204082,76ers,Philadelphia,240,29,39,9,29,38,16,11,4,13,20,106,10
22000771,BOS,1610612738,33,70,0.471,14,34,0.411764706,0.889,19,36,0.527777778,Celtics,Boston,240,16,18,3,29,32,19,5,6,20,22,96,-10
22000772,TOR,1610612761,36,91,0.396,5,33,0.151515152,0.8,31,58,0.534482759,Raptors,Toronto,240,24,30,15,27,42,17,13,3,12,19,101,-9
22000772,LAL,1610612747,39,79,0.494,18,40,0.45,0.636,21,39,0.538461538,Lakers,Los Angeles,240,14,22,11,38,49,29,8,7,21,24,110,9
22000773,MIA,1610612748,44,82,0.537,13,33,0.393939394,0.611,31,49,0.632653061,Heat,Miami,240,11,18,7,28,35,34,9,4,12,16,112,-12
22000773,MEM,1610612763,46,84,0.548,17,41,0.414634146,0.75,29,43,0.674418605,Grizzlies,Memphis,240,15,20,9,33,42,30,11,2,13,13,124,12
22000774,MIL,1610612749,44,86,0.512,14,32,0.4375,0.864,30,54,0.555555556,Bucks,Milwaukee,240,19,22,6,34,40,25,7,2,14,13,121,-1
22000774,GSW,1610612744,46,96,0.479,15,40,0.375,0.882,31,56,0.553571429,Warriors,Golden State,240,15,17,12,30,42,28,6,5,11,18,122,1
22000775,POR,1610612757,37,92,0.402,11,36,0.305555556,0.838,26,56,0.464285714,Trail Blazers,Portland,240,31,37,14,34,48,18,4,5,7,22,116,-17
22000775,LAC,1610612746,46,89,0.517,16,41,0.390243902,0.833,30,48,0.625,Clippers,LA,240,25,30,8,40,48,24,5,5,7,24,133,17
22000776,MIN,1610612750,48,91,0.527,10,28,0.357142857,0.775,38,63,0.603174603,Timberwolves,Minnesota,240,31,40,13,29,42,30,7,2,12,17,137,-4
22000776,IND,1610612754,55,93,0.591,14,28,0.5,0.895,41,65,0.630769231,Pacers,Indiana,240,17,19,7,28,35,32,6,7,13,28,141,4
22000777,WAS,1610612764,49,85,0.576,19,36,0.527777778,0.875,30,49,0.612244898,Wizards,Washington,240,14,16,5,32,37,35,7,3,13,18,131,15
22000777,ORL,1610612753,44,93,0.473,12,31,0.387096774,0.696,32,62,0.516129032,Magic,Orlando,240,16,23,11,28,39,22,11,3,11,16,116,-15
22000778,NYK,1610612752,35,84,0.417,16,33,0.484848485,0.813,19,51,0.37254902,Knicks,New York,240,13,16,5,34,39,22,7,4,14,21,99,-2
22000778,BOS,1610612738,36,86,0.419,15,40,0.375,0.7,21,46,0.456521739,Celtics,Boston,240,14,20,16,37,53,22,6,7,17,14,101,2
22000779,NOP,1610612740,38,89,0.427,6,27,0.222222222,0.744,32,62,0.516129032,Pelicans,New Orleans,240,29,39,17,23,40,23,9,2,14,14,111,-28
22000779,BKN,1610612751,51,92,0.554,19,41,0.463414634,0.818,32,51,0.62745098,Nets,Brooklyn,240,18,22,10,35,45,37,10,8,17,31,139,28
22000780,MEM,1610612763,48,89,0.539,17,40,0.425,0.857,31,49,0.632653061,Grizzlies,Memphis,240,18,21,11,43,54,30,5,5,14,17,131,18
22000780,ATL,1610612737,45,101,0.446,10,28,0.357142857,0.867,35,73,0.479452055,Hawks,Atlanta,240,13,15,11,31,42,26,5,3,7,19,113,-18
22000781,OKC,1610612760,37,85,0.435,16,41,0.390243902,0.706,21,44,0.477272727,Thunder,Oklahoma City,240,12,17,11,35,46,29,4,5,22,11,102,-11
22000781,CHA,1610612766,43,97,0.443,15,44,0.340909091,0.923,28,53,0.528301887,Hornets,Charlotte,240,12,13,11,31,42,27,12,5,11,16,113,11
22000782,SAS,1610612759,38,91,0.418,6,24,0.25,0.667,32,67,0.47761194,Spurs,San Antonio,240,14,21,11,31,42,23,11,4,14,19,96,-10
22000782,DEN,1610612743,40,91,0.44,8,26,0.307692308,0.75,32,65,0.492307692,Nuggets,Denver,240,18,24,12,41,53,26,10,6,17,18,106,10
22000783,UTA,1610612762,46,103,0.447,11,44,0.25,0.667,35,59,0.593220339,Jazz,Utah,265,10,15,7,38,45,14,6,4,13,23,113,-4
22000783,PHX,1610612756,45,101,0.446,11,34,0.323529412,0.8,34,67,0.507462687,Suns,Phoenix,265,16,20,16,45,61,20,7,5,14,21,117,4
22000784,MIA,1610612748,34,71,0.479,10,25,0.4,0.8,24,46,0.52173913,Heat,Miami,240,32,40,9,29,38,22,12,8,20,25,110,6
22000784,LAL,1610612747,35,79,0.443,12,35,0.342857143,0.88,23,44,0.522727273,Lakers,Los Angeles,240,22,25,10,30,40,26,9,3,22,24,104,-6
22000785,OKC,1610612760,40,89,0.449,13,32,0.40625,0.692,27,57,0.473684211,Thunder,Oklahoma City,240,9,13,11,33,44,28,5,5,15,20,102,-27
22000785,CLE,1610612739,48,94,0.511,13,37,0.351351351,0.833,35,57,0.614035088,Cavaliers,Cleveland,240,20,24,9,35,44,35,8,3,7,12,129,27
22000786,MIL,1610612749,38,100,0.38,12,33,0.363636364,0.813,26,67,0.388059701,Bucks,Milwaukee,240,13,16,14,38,52,16,8,1,9,20,101,-15
22000786,DAL,1610612742,43,97,0.443,17,45,0.377777778,0.722,26,52,0.5,Mavericks,Dallas,240,13,18,15,41,56,23,6,8,11,15,116,15
22000787,UTA,1610612762,43,95,0.453,12,42,0.285714286,0.889,31,53,0.58490566,Jazz,Utah,240,24,27,14,44,58,21,4,3,7,15,122,19
22000787,POR,1610612757,38,96,0.396,13,48,0.270833333,0.778,25,48,0.520833333,Trail Blazers,Portland,240,14,18,9,32,41,18,3,5,6,21,103,-19
22000788,PHX,1610612756,36,71,0.507,6,24,0.25,0.833,30,47,0.638297872,Suns,Phoenix,240,25,30,9,27,36,20,6,6,14,18,103,-10
22000788,LAC,1610612746,42,84,0.5,18,37,0.486486486,0.917,24,47,0.510638298,Clippers,LA,240,11,12,9,26,35,26,5,1,10,22,113,10
22000789,SAC,1610612758,38,86,0.442,7,30,0.233333333,0.692,31,56,0.553571429,Kings,Sacramento,240,18,26,6,32,38,20,9,4,12,21,101,-12
22000789,DET,1610612765,44,84,0.524,8,23,0.347826087,0.85,36,61,0.590163934,Pistons,Detroit,240,17,20,7,36,43,24,7,4,16,24,113,12
22000790,ORL,1610612753,38,90,0.422,6,24,0.25,0.774,32,66,0.484848485,Magic,Orlando,240,24,31,12,38,50,23,3,8,15,22,106,-5
22000790,IND,1610612754,38,92,0.413,11,33,0.333333333,0.857,27,59,0.457627119,Pacers,Indiana,240,24,28,11,38,49,26,8,10,14,24,111,5
22000791,CHI,1610612741,41,86,0.477,13,33,0.393939394,0.929,28,53,0.528301887,Bulls,Chicago,240,13,14,8,30,38,25,6,1,13,17,108,-12
22000791,ATL,1610612737,47,84,0.56,7,27,0.259259259,0.826,40,57,0.701754386,Hawks,Atlanta,240,19,23,6,35,41,25,7,4,9,14,120,12
22000792,MIN,1610612750,47,96,0.49,15,42,0.357142857,0.9,32,54,0.592592593,Timberwolves,Minnesota,265,27,30,9,28,37,30,14,0,14,26,136,-9
22000792,BOS,1610612738,47,87,0.54,19,42,0.452380952,0.941,28,45,0.622222222,Celtics,Boston,265,32,34,9,36,45,32,9,5,20,25,145,9
22000793,NYK,1610612752,45,96,0.469,14,32,0.4375,0.879,31,64,0.484375,Knicks,New York,265,29,33,11,37,48,24,7,7,12,25,133,4
22000793,MEM,1610612763,47,94,0.5,14,30,0.466666667,0.618,33,64,0.515625,Grizzlies,Memphis,265,21,34,10,33,43,33,7,6,14,27,129,-4
22000794,TOR,1610612761,53,86,0.616,17,32,0.53125,0.857,36,54,0.666666667,Raptors,Toronto,240,12,14,5,34,39,29,12,11,17,18,135,20
22000794,CLE,1610612739,39,86,0.453,15,35,0.428571429,0.846,24,51,0.470588235,Cavaliers,Cleveland,240,22,26,7,25,32,27,11,5,17,13,115,-20
22000795,PHI,1610612755,33,79,0.418,11,31,0.35483871,0.708,22,48,0.458333333,76ers,Philadelphia,240,17,24,4,43,47,20,8,5,19,23,94,-7
22000795,NOP,1610612740,39,90,0.433,4,22,0.181818182,0.633,35,68,0.514705882,Pelicans,New Orleans,240,19,30,10,46,56,22,11,7,12,17,101,7
22000796,MIL,1610612749,44,98,0.449,14,38,0.368421053,0.739,30,60,0.5,Bucks,Milwaukee,240,17,23,13,35,48,23,10,3,17,14,119,-8
22000796,CHA,1610612766,44,91,0.484,19,50,0.38,0.909,25,41,0.609756098,Hornets,Charlotte,240,20,22,13,36,49,35,4,10,18,19,127,8
22000797,SAS,1610612759,43,93,0.462,9,27,0.333333333,0.857,34,66,0.515151515,Spurs,San Antonio,240,24,28,11,27,38,33,10,2,9,21,119,-2
22000797,DEN,1610612743,43,79,0.544,14,27,0.518518519,0.913,29,52,0.557692308,Nuggets,Denver,240,21,23,9,37,46,32,5,4,18,22,121,2
22000798,WAS,1610612764,43,89,0.483,5,19,0.263157895,0.792,38,70,0.542857143,Wizards,Washington,240,19,24,11,36,47,30,6,1,18,16,110,3
22000798,GSW,1610612744,41,88,0.466,11,36,0.305555556,0.667,30,52,0.576923077,Warriors,Golden State,240,14,21,8,33,41,27,15,3,13,20,107,-3
22000799,LAC,1610612746,48,88,0.545,19,37,0.513513514,0.846,29,51,0.568627451,Clippers,LA,240,11,13,4,34,38,31,10,4,9,24,126,17
22000799,HOU,1610612745,39,83,0.47,12,37,0.324324324,0.704,27,46,0.586956522,Rockets,Houston,240,19,27,12,29,41,28,3,6,14,15,109,-17
22000800,LAL,1610612747,47,93,0.505,19,34,0.558823529,0.65,28,59,0.474576271,Lakers,Los Angeles,240,13,20,12,35,47,30,12,4,14,24,126,25
22000800,BKN,1610612751,35,80,0.438,5,27,0.185185185,0.867,30,53,0.566037736,Nets,Brooklyn,240,26,30,9,33,42,19,6,10,19,20,101,-25
22000801,UTA,1610612762,40,88,0.455,18,50,0.36,0.857,22,38,0.578947368,Jazz,Utah,240,30,35,11,41,52,22,8,5,10,17,128,16
22000801,SAC,1610612758,42,88,0.477,14,42,0.333333333,0.636,28,46,0.608695652,Kings,Sacramento,240,14,22,4,34,38,23,8,4,10,23,112,-16
22000802,HOU,1610612745,41,88,0.466,13,37,0.351351351,0.7,28,51,0.549019608,Rockets,Houston,240,14,20,13,32,45,25,8,3,18,17,109,-16
22000802,GSW,1610612744,49,91,0.538,14,35,0.4,0.813,35,56,0.625,Warriors,Golden State,240,13,16,9,36,45,31,13,5,16,19,125,16
22000803,WAS,1610612764,39,84,0.464,9,25,0.36,0.679,30,59,0.508474576,Wizards,Washington,240,19,28,7,42,49,27,2,1,16,12,106,-28
22000803,PHX,1610612756,55,107,0.514,17,43,0.395348837,1,38,64,0.59375,Suns,Phoenix,240,7,7,5,40,45,36,8,3,3,18,134,28
22000804,POR,1610612757,43,90,0.478,13,29,0.448275862,0.792,30,61,0.491803279,Trail Blazers,Portland,240,19,24,14,35,49,18,5,8,15,20,118,15
22000804,DET,1610612765,37,83,0.446,9,26,0.346153846,0.714,28,57,0.49122807,Pistons,Detroit,240,20,28,9,29,38,25,9,6,11,23,103,-15
22000805,CHA,1610612766,37,80,0.463,15,43,0.348837209,0.857,22,37,0.594594595,Hornets,Charlotte,240,12,14,6,32,38,28,5,5,12,14,101,-4
22000805,ATL,1610612737,38,84,0.452,17,39,0.435897436,0.75,21,45,0.466666667,Hawks,Atlanta,240,12,16,7,34,41,27,7,1,11,11,105,4
22000806,DEN,1610612743,32,88,0.364,8,34,0.235294118,0.833,24,54,0.444444444,Nuggets,Denver,240,15,18,13,33,46,23,5,4,9,20,87,-18
22000806,BOS,1610612738,39,87,0.448,7,33,0.212121212,0.87,32,54,0.592592593,Celtics,Boston,240,20,23,10,42,52,20,4,7,9,18,105,18
22000807,NOP,1610612740,44,86,0.512,7,24,0.291666667,0.808,37,62,0.596774194,Pelicans,New Orleans,240,21,26,14,36,50,30,9,3,16,16,116,7
22000807,CLE,1610612739,41,85,0.482,13,40,0.325,0.824,28,45,0.622222222,Cavaliers,Cleveland,240,14,17,9,27,36,29,7,5,17,23,109,-7
22000808,ORL,1610612753,32,86,0.372,8,36,0.222222222,0.789,24,50,0.48,Magic,Orlando,240,15,19,7,30,37,19,8,6,14,13,87,-37
22000808,MIL,1610612749,46,94,0.489,19,40,0.475,0.867,27,54,0.5,Bucks,Milwaukee,240,13,15,12,44,56,28,8,7,11,15,124,37
22000809,TOR,1610612761,33,79,0.418,11,34,0.323529412,0.826,22,45,0.488888889,Raptors,Toronto,240,19,23,5,35,40,19,8,7,15,23,96,-6
22000809,NYK,1610612752,35,88,0.398,9,35,0.257142857,0.852,26,53,0.490566038,Knicks,New York,240,23,27,11,35,46,19,9,4,13,19,102,6
22000810,SAS,1610612759,45,83,0.542,8,21,0.380952381,0.778,37,62,0.596774194,Spurs,San Antonio,240,21,27,10,31,41,20,10,7,14,20,119,2
22000810,DAL,1610612742,45,94,0.479,13,42,0.30952381,0.933,32,52,0.615384615,Mavericks,Dallas,240,14,15,11,26,37,25,5,3,12,21,117,-2
22000811,MEM,1610612763,53,115,0.461,6,20,0.3,0.684,47,95,0.494736842,Grizzlies,Memphis,240,13,19,24,26,50,27,11,6,6,12,125,-7
22000811,IND,1610612754,52,99,0.525,13,37,0.351351351,0.882,39,62,0.629032258,Pacers,Indiana,240,15,17,15,38,53,35,5,10,12,16,132,7
22000812,MIN,1610612750,40,81,0.494,16,36,0.444444444,1,24,45,0.533333333,Timberwolves,Minnesota,240,25,25,3,33,36,27,7,6,14,14,121,4
22000812,CHI,1610612741,47,92,0.511,15,38,0.394736842,0.615,32,54,0.592592593,Bulls,Chicago,240,8,13,8,30,38,30,10,8,13,19,117,-4
22000813,LAC,1610612746,50,80,0.625,15,27,0.555555556,0.762,35,53,0.660377358,Clippers,LA,240,16,21,7,30,37,35,4,5,16,18,131,7
22000813,DET,1610612765,46,87,0.529,15,32,0.46875,0.895,31,55,0.563636364,Pistons,Detroit,240,17,19,12,19,31,33,12,4,12,24,124,-7
22000814,POR,1610612757,37,77,0.481,11,35,0.314285714,0.684,26,42,0.619047619,Trail Blazers,Portland,240,13,19,8,33,41,21,5,5,17,16,98,-9
22000814,MIA,1610612748,41,83,0.494,12,29,0.413793103,0.65,29,54,0.537037037,Heat,Miami,240,13,20,6,24,30,21,12,4,7,18,107,9
22000815,NYK,1610612752,42,89,0.472,5,27,0.185185185,0.815,37,62,0.596774194,Knicks,New York,240,22,27,15,32,47,18,14,9,15,20,111,15
22000815,LAL,1610612747,35,80,0.438,12,36,0.333333333,0.778,23,44,0.522727273,Lakers,Los Angeles,240,14,18,4,29,33,22,5,7,24,21,96,-15
22000816,SAS,1610612759,48,93,0.516,10,25,0.4,0.778,38,68,0.558823529,Spurs,San Antonio,240,14,18,12,35,47,30,6,5,9,26,120,23
22000816,ORL,1610612753,36,80,0.45,5,20,0.25,0.625,31,60,0.516666667,Magic,Orlando,240,20,32,11,33,44,15,6,2,15,17,97,-23
22000817,MIN,1610612750,30,87,0.345,13,49,0.265306122,0.727,17,38,0.447368421,Timberwolves,Minnesota,240,24,33,11,33,44,16,13,12,14,20,97,-30
22000817,BKN,1610612751,46,91,0.505,15,36,0.416666667,0.833,31,55,0.563636364,Nets,Brooklyn,240,20,24,11,46,57,31,8,4,18,22,127,30
22000818,PHI,1610612755,39,80,0.487,12,31,0.387096774,0.697,27,49,0.551020408,76ers,Philadelphia,240,23,33,6,34,40,24,9,4,9,20,113,18
22000818,DAL,1610612742,35,83,0.422,9,36,0.25,0.8,26,47,0.553191489,Mavericks,Dallas,240,16,20,11,35,46,16,7,3,15,24,95,-18
22000819,SAC,1610612758,39,90,0.433,10,35,0.285714286,0.595,29,55,0.527272727,Kings,Sacramento,240,22,37,8,26,34,21,14,3,10,26,110,-7
22000819,NOP,1610612740,42,77,0.545,6,19,0.315789474,0.692,36,58,0.620689655,Pelicans,New Orleans,240,27,39,9,42,51,24,8,5,21,23,117,7
22000820,WAS,1610612764,47,90,0.522,9,19,0.473684211,0.786,38,71,0.535211268,Wizards,Washington,240,22,28,8,36,44,29,7,4,7,27,125,4
22000820,UTA,1610612762,41,85,0.482,15,36,0.416666667,0.774,26,49,0.530612245,Jazz,Utah,240,24,31,9,34,43,21,2,3,14,23,121,-4
22000821,GSW,1610612744,39,81,0.481,18,44,0.409090909,0.909,21,37,0.567567568,Warriors,Golden State,240,20,22,4,32,36,23,11,3,16,22,116,9
22000821,DEN,1610612743,39,83,0.47,8,26,0.307692308,0.84,31,57,0.543859649,Nuggets,Denver,240,21,25,10,31,41,23,11,2,19,24,107,-9
22000822,PHX,1610612756,45,94,0.479,25,45,0.555555556,0.611,20,49,0.408163265,Suns,Phoenix,240,11,18,12,30,42,33,14,3,13,18,126,6
22000822,HOU,1610612745,44,87,0.506,17,42,0.404761905,0.789,27,45,0.6,Rockets,Houston,240,15,19,12,39,51,32,9,3,21,15,120,-6
22000823,LAC,1610612746,48,89,0.539,13,28,0.464285714,0.895,35,61,0.573770492,Clippers,LA,240,17,19,6,42,48,34,10,5,14,20,126,11
22000823,IND,1610612754,44,96,0.458,9,40,0.225,0.818,35,56,0.625,Pacers,Indiana,240,18,22,9,33,42,14,9,5,12,17,115,-11
22000824,TOR,1610612761,42,88,0.477,10,39,0.256410256,0.692,32,49,0.653061224,Raptors,Toronto,240,9,13,6,36,42,16,7,4,13,19,103,-5
22000824,ATL,1610612737,40,84,0.476,13,30,0.433333333,0.682,27,54,0.5,Hawks,Atlanta,240,15,22,8,31,39,21,7,2,13,16,108,5
22000825,LAL,1610612747,34,82,0.415,16,44,0.363636364,0.944,18,38,0.473684211,Lakers,Los Angeles,240,17,18,8,30,38,24,9,2,11,18,101,8
22000825,CHA,1610612766,36,83,0.434,9,35,0.257142857,0.667,27,48,0.5625,Hornets,Charlotte,240,12,18,12,33,45,22,5,3,16,18,93,-8
22000826,UTA,1610612762,36,86,0.419,17,47,0.361702128,0.85,19,39,0.487179487,Jazz,Utah,240,17,20,11,40,51,24,6,10,12,18,106,10
22000826,OKC,1610612760,36,93,0.387,14,34,0.411764706,0.556,22,59,0.372881356,Thunder,Oklahoma City,240,10,18,15,35,50,13,8,1,12,23,96,-10
22000827,PHX,1610612756,38,82,0.463,13,42,0.30952381,0.944,25,40,0.625,Suns,Phoenix,240,17,18,9,39,48,28,11,2,19,18,106,20
22000827,MIA,1610612748,31,82,0.378,9,44,0.204545455,0.789,22,38,0.578947368,Heat,Miami,240,15,19,8,28,36,24,13,2,16,20,86,-20
22000828,POR,1610612757,43,90,0.478,17,43,0.395348837,0.706,26,47,0.553191489,Trail Blazers,Portland,240,12,17,8,38,46,31,6,5,14,22,115,-1
22000828,BOS,1610612738,42,90,0.467,15,35,0.428571429,0.708,27,55,0.490909091,Celtics,Boston,240,17,24,9,37,46,30,5,4,9,19,116,1
22000829,CLE,1610612739,37,76,0.487,13,31,0.419354839,0.842,24,45,0.533333333,Cavaliers,Cleveland,240,16,19,9,38,47,27,9,7,15,11,103,13
22000829,CHA,1610612766,34,84,0.405,16,44,0.363636364,0.5,18,40,0.45,Hornets,Charlotte,240,6,12,10,28,38,23,8,5,12,18,90,-13
22000830,PHI,1610612755,45,87,0.517,13,28,0.464285714,0.8,32,59,0.542372881,76ers,Philadelphia,240,20,25,4,28,32,23,8,9,10,21,123,6
22000830,BKN,1610612751,43,83,0.518,4,21,0.19047619,0.9,39,62,0.629032258,Nets,Brooklyn,240,27,30,11,32,43,23,6,3,15,21,117,-6
22000831,TOR,1610612761,41,88,0.466,14,30,0.466666667,0.84,27,58,0.465517241,Raptors,Toronto,240,21,25,13,41,54,21,8,5,12,19,117,5
22000831,SAS,1610612759,38,89,0.427,17,39,0.435897436,0.704,21,50,0.42,Spurs,San Antonio,240,19,27,12,29,41,26,6,7,13,19,112,-5
22000832,LAC,1610612746,37,93,0.398,7,29,0.24137931,0.905,30,64,0.46875,Clippers,LA,240,19,21,15,32,47,10,8,2,11,20,100,2
22000832,DET,1610612765,37,85,0.435,7,24,0.291666667,0.773,30,61,0.491803279,Pistons,Detroit,240,17,22,11,35,46,17,5,4,16,21,98,-2
22000833,ORL,1610612753,44,89,0.494,12,27,0.444444444,0.75,32,62,0.516129032,Magic,Orlando,240,15,20,13,33,46,29,8,10,7,15,115,9
22000833,CHI,1610612741,41,86,0.477,17,37,0.459459459,0.778,24,49,0.489795918,Bulls,Chicago,240,7,9,7,33,40,23,7,6,12,16,106,-9
22000834,MIN,1610612750,34,92,0.37,15,41,0.365853659,0.71,19,51,0.37254902,Timberwolves,Minnesota,240,22,31,10,37,47,22,13,7,16,17,105,-25
22000834,MIL,1610612749,46,98,0.469,19,40,0.475,0.826,27,58,0.465517241,Bucks,Milwaukee,240,19,23,7,45,52,26,14,4,16,20,130,25
22000835,NYK,1610612752,44,97,0.454,17,33,0.515151515,0.846,27,64,0.421875,Knicks,New York,240,11,13,11,37,48,19,6,5,6,17,116,10
22000835,NOP,1610612740,40,88,0.455,6,28,0.214285714,0.833,34,60,0.566666667,Pelicans,New Orleans,240,20,24,9,40,49,25,3,5,9,12,106,-10
22000836,OKC,1610612760,44,92,0.478,7,27,0.259259259,0.56,37,65,0.569230769,Thunder,Oklahoma City,240,14,25,17,33,50,22,6,2,21,22,109,-38
22000836,GSW,1610612744,52,95,0.547,24,47,0.510638298,0.826,28,48,0.583333333,Warriors,Golden State,240,19,23,9,32,41,39,12,6,14,20,147,38
22000837,MEM,1610612763,42,90,0.467,13,34,0.382352941,0.762,29,56,0.517857143,Grizzlies,Memphis,240,16,21,11,34,45,27,7,3,7,18,113,-1
22000837,DAL,1610612742,44,88,0.5,13,40,0.325,0.765,31,48,0.645833333,Mavericks,Dallas,240,13,17,8,37,45,25,4,3,11,17,114,1
22000838,MIA,1610612748,39,79,0.494,13,32,0.40625,0.833,26,47,0.553191489,Heat,Miami,240,15,18,4,26,30,29,7,8,8,13,106,-17
22000838,DEN,1610612743,48,89,0.539,17,36,0.472222222,0.769,31,53,0.58490566,Nuggets,Denver,240,10,13,11,32,43,32,5,7,10,19,123,17
22000839,WAS,1610612764,47,90,0.522,7,24,0.291666667,0.815,40,66,0.606060606,Wizards,Washington,240,22,27,14,42,56,23,12,3,24,18,123,12
22000839,SAC,1610612758,42,91,0.462,9,27,0.333333333,0.75,33,64,0.515625,Kings,Sacramento,240,18,24,5,25,30,22,17,8,17,22,111,-12
22000840,MIL,1610612749,46,95,0.484,16,43,0.372093023,0.706,30,52,0.576923077,Bucks,Milwaukee,240,12,17,14,37,51,25,8,1,8,16,120,11
22000840,ATL,1610612737,39,86,0.453,14,34,0.411764706,0.895,25,52,0.480769231,Hawks,Atlanta,240,17,19,8,31,39,23,5,4,11,15,109,-11
22000841,GSW,1610612744,47,92,0.511,17,46,0.369565217,0.8,30,46,0.652173913,Warriors,Golden State,240,8,10,9,38,47,33,9,5,15,24,119,18
22000841,CLE,1610612739,35,81,0.432,10,31,0.322580645,0.778,25,50,0.5,Cavaliers,Cleveland,240,21,27,8,31,39,21,11,2,13,20,101,-18
22000842,LAL,1610612747,44,98,0.449,12,37,0.324324324,0.684,32,61,0.524590164,Lakers,Los Angeles,240,13,19,11,25,36,28,12,2,8,16,113,-8
22000842,BOS,1610612738,48,85,0.565,14,32,0.4375,0.846,34,53,0.641509434,Celtics,Boston,240,11,13,7,41,48,33,4,6,21,20,121,8
22000843,SAC,1610612758,43,78,0.551,14,30,0.466666667,0.737,29,48,0.604166667,Kings,Sacramento,240,14,19,4,28,32,22,7,4,15,16,114,-8
22000843,PHX,1610612756,48,86,0.558,14,38,0.368421053,0.857,34,48,0.708333333,Suns,Phoenix,240,12,14,10,29,39,30,9,4,11,18,122,8
22000844,UTA,1610612762,42,87,0.483,16,42,0.380952381,0.792,26,45,0.577777778,Jazz,Utah,240,19,24,10,46,56,22,5,6,20,19,119,8
22000844,IND,1610612754,41,105,0.39,13,39,0.333333333,0.941,28,66,0.424242424,Pacers,Indiana,240,16,17,14,29,43,23,13,3,10,19,111,-8
22000845,OKC,1610612760,39,97,0.402,7,39,0.179487179,0.731,32,58,0.551724138,Thunder,Oklahoma City,240,19,26,18,38,56,19,13,8,21,23,104,-6
22000845,DET,1610612765,38,90,0.422,10,35,0.285714286,0.706,28,55,0.509090909,Pistons,Detroit,240,24,34,15,39,54,22,13,7,18,24,110,6
22000846,PHI,1610612755,35,83,0.422,14,44,0.318181818,0.733,21,39,0.538461538,76ers,Philadelphia,240,22,30,11,35,46,21,13,7,12,19,106,3
22000846,LAC,1610612746,37,82,0.451,19,39,0.487179487,0.625,18,43,0.418604651,Clippers,LA,240,10,16,8,35,43,26,6,3,19,26,103,-3
22000847,WAS,1610612764,45,96,0.469,4,27,0.148148148,0.719,41,69,0.594202899,Wizards,Washington,265,23,32,3,43,46,24,5,7,13,24,117,2
22000847,NOP,1610612740,40,97,0.412,7,28,0.25,0.848,33,69,0.47826087,Pelicans,New Orleans,265,28,33,11,45,56,26,11,7,15,22,115,-2
22000848,CHA,1610612766,44,83,0.53,12,34,0.352941176,0.75,32,49,0.653061224,Hornets,Charlotte,240,15,20,8,29,37,26,12,3,19,18,115,-15
22000848,BKN,1610612751,47,85,0.553,21,41,0.512195122,0.938,26,44,0.590909091,Nets,Brooklyn,240,15,16,7,30,37,35,12,5,18,17,130,15
22000849,TOR,1610612761,41,82,0.5,14,35,0.4,0.944,27,47,0.574468085,Raptors,Toronto,240,17,18,8,34,42,24,6,10,14,24,113,11
22000849,ORL,1610612753,35,77,0.455,8,23,0.347826087,0.706,27,54,0.5,Magic,Orlando,240,24,34,6,29,35,20,8,4,10,14,102,-11
22000850,MEM,1610612763,45,86,0.523,17,40,0.425,0.792,28,46,0.608695652,Grizzlies,Memphis,240,19,24,6,36,42,33,9,4,5,17,126,11
22000850,CHI,1610612741,45,96,0.469,13,34,0.382352941,0.8,32,62,0.516129032,Bulls,Chicago,240,12,15,13,33,46,34,3,1,11,20,115,-11
22000851,HOU,1610612745,38,86,0.442,11,35,0.314285714,0.667,27,51,0.529411765,Rockets,Houston,240,12,18,8,27,35,23,7,3,14,19,99,-29
22000851,DEN,1610612743,46,94,0.489,9,31,0.290322581,0.871,37,63,0.587301587,Nuggets,Denver,240,27,31,18,36,54,22,11,3,9,15,128,29
22000852,MIN,1610612750,42,81,0.519,15,36,0.416666667,0.69,27,45,0.6,Timberwolves,Minnesota,240,20,29,10,35,45,30,8,2,17,22,119,8
22000852,MIA,1610612748,39,80,0.487,14,34,0.411764706,0.731,25,46,0.543478261,Heat,Miami,240,19,26,7,26,33,33,11,5,14,28,111,-8
22000853,SAS,1610612759,45,95,0.474,7,23,0.304347826,0.9,38,72,0.527777778,Spurs,San Antonio,240,9,10,14,35,49,30,7,9,14,14,106,-1
22000853,POR,1610612757,41,89,0.461,11,29,0.379310345,0.875,30,60,0.5,Trail Blazers,Portland,240,14,16,9,29,38,23,9,6,11,12,107,1
22000854,NYK,1610612752,44,86,0.512,14,28,0.5,0.714,30,58,0.517241379,Knicks,New York,240,15,21,9,36,45,22,4,5,9,20,117,8
22000854,DAL,1610612742,40,91,0.44,15,45,0.333333333,0.737,25,46,0.543478261,Mavericks,Dallas,240,14,19,10,31,41,30,6,7,9,17,109,-8
22000855,UTA,1610612762,42,101,0.416,23,59,0.389830508,1,19,42,0.452380952,Jazz,Utah,265,8,8,6,31,37,31,10,3,15,21,115,-12
22000855,LAL,1610612747,48,93,0.516,11,33,0.333333333,0.87,37,60,0.616666667,Lakers,Los Angeles,265,20,23,11,41,52,26,8,8,14,14,127,12
22000856,WAS,1610612764,50,94,0.532,9,16,0.5625,0.632,41,78,0.525641026,Wizards,Washington,240,12,19,10,38,48,25,11,6,12,24,121,21
22000856,DET,1610612765,37,84,0.44,9,27,0.333333333,0.739,28,57,0.49122807,Pistons,Detroit,240,17,23,9,36,45,19,7,6,18,20,100,-21
22000857,CLE,1610612739,39,88,0.443,12,30,0.4,0.857,27,58,0.465517241,Cavaliers,Cleveland,240,6,7,11,33,44,27,6,1,10,10,96,-10
22000857,CHI,1610612741,41,82,0.5,16,40,0.4,0.889,25,42,0.595238095,Bulls,Chicago,240,8,9,4,34,38,30,6,2,10,15,106,10
22000858,GSW,1610612744,41,80,0.512,17,40,0.425,0.75,24,40,0.6,Warriors,Golden State,240,15,20,8,32,40,22,6,2,17,23,114,-5
22000858,BOS,1610612738,44,94,0.468,15,46,0.326086957,0.8,29,48,0.604166667,Celtics,Boston,240,16,20,14,31,45,18,9,2,9,18,119,5
22000859,MIL,1610612749,39,91,0.429,16,47,0.340425532,0.778,23,44,0.522727273,Bucks,Milwaukee,240,21,27,13,32,45,27,7,1,16,8,115,-13
22000859,MEM,1610612763,51,93,0.548,15,40,0.375,0.917,36,53,0.679245283,Grizzlies,Memphis,240,11,12,7,36,43,31,10,3,10,18,128,13
22000860,SAS,1610612759,45,89,0.506,12,29,0.413793103,0.75,33,60,0.55,Spurs,San Antonio,240,9,12,5,41,46,23,10,9,12,17,111,26
22000860,PHX,1610612756,36,90,0.4,6,27,0.222222222,0.438,30,63,0.476190476,Suns,Phoenix,240,7,16,15,33,48,19,7,2,14,14,85,-26
22000861,IND,1610612754,45,92,0.489,10,32,0.3125,0.85,35,60,0.583333333,Pacers,Indiana,240,17,20,8,33,41,33,7,5,12,27,117,-12
22000861,ATL,1610612737,45,92,0.489,13,32,0.40625,0.765,32,60,0.533333333,Hawks,Atlanta,240,26,34,14,37,51,20,8,7,10,19,129,12
22000862,NYK,1610612752,45,95,0.474,11,29,0.379310345,0.875,34,66,0.515151515,Knicks,New York,265,21,24,13,36,49,27,9,6,13,26,122,10
22000862,NOP,1610612740,41,101,0.406,6,27,0.222222222,0.8,35,74,0.472972973,Pelicans,New Orleans,265,24,30,20,32,52,25,6,4,12,16,112,-10
22000863,MIA,1610612748,38,87,0.437,16,39,0.41025641,0.81,22,48,0.458333333,Heat,Miami,240,17,21,16,37,53,28,9,1,16,13,109,2
22000863,BKN,1610612751,39,82,0.476,17,43,0.395348837,0.667,22,39,0.564102564,Nets,Brooklyn,240,12,18,8,30,38,26,10,6,11,17,107,-2
22000864,ORL,1610612753,41,91,0.451,11,32,0.34375,0.895,30,59,0.508474576,Magic,Orlando,240,17,19,9,27,36,28,10,5,15,19,110,-4
22000864,HOU,1610612745,42,82,0.512,16,34,0.470588235,0.7,26,48,0.541666667,Rockets,Houston,240,14,20,10,33,43,26,7,7,19,21,114,4
22000865,TOR,1610612761,37,96,0.385,17,38,0.447368421,0.875,20,58,0.344827586,Raptors,Toronto,240,21,24,16,31,47,23,9,5,13,15,112,6
22000865,OKC,1610612760,37,82,0.451,14,33,0.424242424,0.857,23,49,0.469387755,Thunder,Oklahoma City,240,18,21,9,37,46,22,6,8,21,19,106,-6
22000866,SAC,1610612758,44,89,0.494,11,24,0.458333333,0.88,33,65,0.507692308,Kings,Sacramento,240,22,25,10,32,42,22,11,3,6,19,121,14
22000866,DAL,1610612742,39,87,0.448,16,48,0.333333333,0.65,23,39,0.58974359,Mavericks,Dallas,240,13,20,10,32,42,15,3,8,14,20,107,-14
22000867,MIN,1610612750,36,88,0.409,17,45,0.377777778,0.762,19,43,0.441860465,Timberwolves,Minnesota,240,16,21,6,31,37,27,6,7,11,21,105,-19
22000867,LAC,1610612746,45,89,0.506,21,42,0.5,0.765,24,47,0.510638298,Clippers,LA,240,13,17,8,40,48,31,6,3,14,26,124,19
22000868,DET,1610612765,42,86,0.488,10,27,0.37037037,0.714,32,59,0.542372881,Pistons,Detroit,240,15,21,10,34,44,25,8,5,17,22,109,4
22000868,CLE,1610612739,42,86,0.488,5,26,0.192307692,0.8,37,60,0.616666667,Cavaliers,Cleveland,240,16,20,9,30,39,24,9,8,17,21,105,-4
22000869,CHI,1610612741,41,91,0.451,11,32,0.34375,0.9,30,59,0.508474576,Bulls,Chicago,240,9,10,9,31,40,30,11,8,12,15,102,6
22000869,BOS,1610612738,36,77,0.468,10,25,0.4,0.933,26,52,0.5,Celtics,Boston,240,14,15,3,36,39,21,8,3,15,15,96,-6
22000870,PHI,1610612755,35,89,0.393,12,32,0.375,0.778,23,57,0.403508772,76ers,Philadelphia,240,14,18,10,32,42,26,9,6,13,21,96,-11
22000870,GSW,1610612744,34,76,0.447,14,32,0.4375,0.781,20,44,0.454545455,Warriors,Golden State,240,25,32,6,39,45,15,2,5,16,19,107,11
22000871,MIA,1610612748,45,93,0.484,19,48,0.395833333,0.571,26,45,0.577777778,Heat,Miami,240,4,7,11,41,52,31,7,5,13,19,113,22
22000871,HOU,1610612745,33,85,0.388,9,38,0.236842105,0.941,24,47,0.510638298,Rockets,Houston,240,16,17,6,35,41,20,8,3,13,7,91,-22
22000872,WAS,1610612764,46,91,0.505,10,31,0.322580645,0.586,36,60,0.6,Wizards,Washington,240,17,29,8,34,42,31,8,2,12,19,119,12
22000872,OKC,1610612760,36,83,0.434,13,33,0.393939394,0.815,23,50,0.46,Thunder,Oklahoma City,240,22,27,9,39,48,23,6,2,19,26,107,-12
22000873,PHX,1610612756,51,106,0.481,17,42,0.404761905,0.9,34,64,0.53125,Suns,Phoenix,265,9,10,8,37,45,28,7,4,11,16,128,1
22000873,MIL,1610612749,49,102,0.48,11,34,0.323529412,0.947,38,68,0.558823529,Bucks,Milwaukee,265,18,19,9,42,51,19,7,3,11,15,127,-1
22000874,MEM,1610612763,51,107,0.477,17,40,0.425,0.75,34,67,0.507462687,Grizzlies,Memphis,290,18,24,10,37,47,33,15,3,14,24,137,-2
22000874,DEN,1610612743,51,102,0.5,15,39,0.384615385,0.846,36,63,0.571428571,Nuggets,Denver,290,22,26,13,45,58,30,6,6,24,19,139,2
22000875,UTA,1610612762,43,75,0.573,15,33,0.454545455,0.909,28,42,0.666666667,Jazz,Utah,240,10,11,2,40,42,29,5,5,17,20,111,14
22000875,LAL,1610612747,34,79,0.43,12,28,0.428571429,0.68,22,51,0.431372549,Lakers,Los Angeles,240,17,25,5,27,32,17,10,1,10,14,97,-14
22000876,ORL,1610612753,34,86,0.395,8,37,0.216216216,0.69,26,49,0.530612245,Magic,Orlando,240,20,29,6,34,40,13,11,3,10,19,96,-16
22000876,ATL,1610612737,39,94,0.415,9,34,0.264705882,0.862,30,60,0.5,Hawks,Atlanta,240,25,29,18,47,65,20,6,3,13,22,112,16
22000877,NYK,1610612752,40,83,0.482,18,45,0.4,0.917,22,38,0.578947368,Knicks,New York,240,11,12,11,28,39,22,5,6,9,13,109,12
22000877,CHA,1610612766,39,86,0.453,16,39,0.41025641,0.375,23,47,0.489361702,Hornets,Charlotte,240,3,8,11,28,39,26,6,3,12,10,97,-12
22000878,NOP,1610612740,51,91,0.56,12,33,0.363636364,0.625,39,58,0.672413793,Pelicans,New Orleans,240,15,24,7,30,37,28,5,2,13,21,129,-5
22000878,BKN,1610612751,49,89,0.551,14,37,0.378378378,0.786,35,52,0.673076923,Nets,Brooklyn,240,22,28,10,34,44,30,7,2,13,21,134,5
22000879,POR,1610612757,42,94,0.447,14,44,0.318181818,0.737,28,50,0.56,Trail Blazers,Portland,240,14,19,13,29,42,22,7,4,6,16,112,-1
22000879,LAC,1610612746,45,90,0.5,11,38,0.289473684,0.8,34,52,0.653846154,Clippers,LA,240,12,15,10,35,45,24,3,3,10,15,113,1
22000880,SAC,1610612758,44,97,0.454,18,42,0.428571429,0.875,26,55,0.472727273,Kings,Sacramento,240,14,16,13,26,39,28,10,3,10,17,120,-14
22000880,MIN,1610612750,51,90,0.567,18,43,0.418604651,0.737,33,47,0.70212766,Timberwolves,Minnesota,240,14,19,12,38,50,34,5,9,18,16,134,14
22000881,CLE,1610612739,45,88,0.511,16,36,0.444444444,0.789,29,52,0.557692308,Cavaliers,Cleveland,240,15,19,9,32,41,27,8,1,10,19,121,16
22000881,CHI,1610612741,39,79,0.494,13,37,0.351351351,0.778,26,42,0.619047619,Bulls,Chicago,240,14,18,7,34,41,27,6,4,19,24,105,-16
22000882,OKC,1610612760,48,104,0.462,9,29,0.310344828,0.688,39,75,0.52,Thunder,Oklahoma City,240,11,16,17,38,55,26,8,3,17,18,116,-6
22000882,IND,1610612754,46,101,0.455,14,40,0.35,0.8,32,61,0.524590164,Pacers,Indiana,240,16,20,14,33,47,30,13,7,11,16,122,6
22000883,PHX,1610612756,41,86,0.477,15,42,0.357142857,0.905,26,44,0.590909091,Suns,Phoenix,240,19,21,10,23,33,30,7,8,8,21,116,3
22000883,PHI,1610612755,41,80,0.512,13,25,0.52,0.692,28,55,0.509090909,76ers,Philadelphia,240,18,26,14,30,44,24,7,7,16,19,113,-3
22000884,TOR,1610612761,39,90,0.433,18,47,0.382978723,0.857,21,43,0.488372093,Raptors,Toronto,240,18,21,9,39,48,23,7,8,10,20,114,11
22000884,BKN,1610612751,36,91,0.396,13,41,0.317073171,0.783,23,50,0.46,Nets,Brooklyn,240,18,23,12,38,50,19,3,6,13,17,103,-11
22000885,WAS,1610612764,38,91,0.418,10,28,0.357142857,0.842,28,63,0.444444444,Wizards,Washington,240,32,38,15,46,61,23,12,7,22,16,118,4
22000885,GSW,1610612744,40,101,0.396,15,45,0.333333333,0.905,25,56,0.446428571,Warriors,Golden State,240,19,21,10,34,44,22,15,5,17,23,114,-4
22000886,NYK,1610612752,49,91,0.538,19,35,0.542857143,0.8,30,56,0.535714286,Knicks,New York,265,20,25,8,41,49,29,8,3,14,19,137,10
22000886,ATL,1610612737,49,102,0.48,12,34,0.352941176,0.708,37,68,0.544117647,Hawks,Atlanta,265,17,24,12,29,41,28,10,3,10,18,127,-10
22000887,UTA,1610612762,41,90,0.456,17,46,0.369565217,0.813,24,44,0.545454545,Jazz,Utah,240,13,16,9,52,61,27,7,4,12,16,112,23
22000887,HOU,1610612745,35,99,0.354,10,49,0.204081633,0.529,25,50,0.5,Rockets,Houston,240,9,17,12,38,50,17,7,5,11,21,89,-23
22000888,SAS,1610612759,31,77,0.403,10,35,0.285714286,0.75,21,42,0.5,Spurs,San Antonio,240,15,20,7,31,38,21,1,7,10,15,87,-20
22000888,MIA,1610612748,39,83,0.47,13,31,0.419354839,0.8,26,52,0.5,Heat,Miami,240,16,20,9,35,44,28,8,1,7,20,107,20
22000889,MEM,1610612763,38,84,0.452,13,30,0.433333333,0.696,25,54,0.462962963,Grizzlies,Memphis,240,16,23,11,31,42,19,6,8,13,29,105,-12
22000889,LAC,1610612746,38,84,0.452,14,27,0.518518519,0.75,24,57,0.421052632,Clippers,LA,240,27,36,10,33,43,28,4,5,12,17,117,12
22000890,POR,1610612757,40,87,0.46,12,36,0.333333333,0.867,28,51,0.549019608,Trail Blazers,Portland,240,13,15,9,32,41,21,7,2,11,16,105,-1
22000890,DEN,1610612743,39,88,0.443,13,39,0.333333333,0.882,26,49,0.530612245,Nuggets,Denver,240,15,17,16,30,46,24,7,5,13,16,106,1
22000891,SAC,1610612758,43,74,0.581,17,33,0.515151515,0.806,26,41,0.634146341,Kings,Sacramento,240,25,31,4,29,33,29,7,5,14,20,128,3
22000891,MIN,1610612750,46,87,0.529,15,34,0.441176471,0.818,31,53,0.58490566,Timberwolves,Minnesota,240,18,22,9,25,34,30,7,4,10,21,125,-3
22000892,PHX,1610612756,36,88,0.409,6,35,0.171428571,0.889,30,53,0.566037736,Suns,Phoenix,240,8,9,10,28,38,18,10,2,17,23,86,-13
22000892,BOS,1610612738,33,77,0.429,12,40,0.3,0.875,21,37,0.567567568,Celtics,Boston,240,21,24,10,38,48,20,7,2,20,12,99,13
22000893,ORL,1610612753,36,98,0.367,13,36,0.361111111,0.789,23,62,0.370967742,Magic,Orlando,240,15,19,13,27,40,13,6,6,4,18,100,-35
22000893,NOP,1610612740,50,90,0.556,12,28,0.428571429,0.885,38,62,0.612903226,Pelicans,New Orleans,240,23,26,12,46,58,34,2,3,14,16,135,35
22000894,PHI,1610612755,46,91,0.505,12,27,0.444444444,0.722,34,64,0.53125,76ers,Philadelphia,240,13,18,7,26,33,27,7,3,8,17,117,-7
22000894,MIL,1610612749,45,81,0.556,20,40,0.5,0.609,25,41,0.609756098,Bucks,Milwaukee,240,14,23,6,39,45,32,6,8,16,16,124,7
22000895,SAS,1610612759,37,80,0.463,11,24,0.458333333,0.778,26,56,0.464285714,Spurs,San Antonio,240,21,27,11,32,43,28,12,7,10,19,106,15
22000895,DET,1610612765,35,77,0.455,8,22,0.363636364,0.591,27,55,0.490909091,Pistons,Detroit,240,13,22,9,34,43,15,2,5,17,22,91,-15
22000896,CHI,1610612741,43,87,0.494,14,43,0.325581395,0.727,29,44,0.659090909,Bulls,Chicago,240,8,11,11,39,50,30,8,2,17,14,108,17
22000896,CHA,1610612766,35,82,0.427,8,31,0.258064516,0.765,27,51,0.529411765,Hornets,Charlotte,240,13,17,7,31,38,30,5,3,14,18,91,-17
22000897,LAL,1610612747,43,90,0.478,10,30,0.333333333,0.824,33,60,0.55,Lakers,Los Angeles,240,14,17,12,33,45,26,7,5,16,28,110,-5
22000897,DAL,1610612742,40,82,0.488,9,24,0.375,0.722,31,58,0.534482759,Mavericks,Dallas,240,26,36,9,29,38,23,11,5,12,15,115,5
22000898,MIA,1610612748,38,79,0.481,13,37,0.351351351,0.875,25,42,0.595238095,Heat,Miami,240,14,16,6,24,30,24,10,5,13,18,103,-15
22000898,ATL,1610612737,43,80,0.537,15,35,0.428571429,0.895,28,45,0.622222222,Hawks,Atlanta,240,17,19,8,30,38,24,12,2,14,17,118,15
22000899,BOS,1610612738,38,94,0.404,17,42,0.404761905,0.688,21,52,0.403846154,Celtics,Boston,240,11,16,15,39,54,21,6,6,19,20,104,-5
22000899,BKN,1610612751,37,86,0.43,11,32,0.34375,0.857,26,54,0.481481481,Nets,Brooklyn,240,24,28,6,41,47,26,12,7,11,19,109,5
22000900,CLE,1610612739,41,80,0.512,10,30,0.333333333,0.714,31,50,0.62,Cavaliers,Cleveland,240,10,14,11,36,47,27,4,1,16,20,102,-6
22000900,CHA,1610612766,40,94,0.426,14,40,0.35,0.778,26,54,0.481481481,Hornets,Charlotte,240,14,18,15,23,38,26,7,1,5,16,108,6
22000901,LAC,1610612746,39,97,0.402,12,34,0.352941176,0.826,27,63,0.428571429,Clippers,LA,240,19,23,14,44,58,22,8,3,14,19,109,5
22000901,HOU,1610612745,36,89,0.404,13,42,0.30952381,0.864,23,47,0.489361702,Rockets,Houston,240,19,22,9,38,47,24,7,5,14,19,104,-5
22000902,WAS,1610612764,48,93,0.516,18,32,0.5625,0.938,30,61,0.491803279,Wizards,Washington,240,15,16,12,38,50,25,7,7,20,23,129,20
22000902,OKC,1610612760,39,93,0.419,10,33,0.303030303,0.84,29,60,0.483333333,Thunder,Oklahoma City,240,21,25,14,26,40,18,12,7,16,17,109,-20
22000903,GSW,1610612744,45,84,0.536,15,39,0.384615385,0.722,30,45,0.666666667,Warriors,Golden State,240,13,18,7,45,52,40,8,4,14,15,118,21
22000903,DEN,1610612743,34,88,0.386,13,46,0.282608696,0.8,21,42,0.5,Nuggets,Denver,240,16,20,6,30,36,26,9,7,9,14,97,-21
22000904,TOR,1610612761,36,83,0.434,17,44,0.386363636,0.737,19,39,0.487179487,Raptors,Toronto,240,14,19,5,28,33,31,6,3,7,19,103,-17
22000904,NYK,1610612752,42,75,0.56,16,31,0.516129032,0.833,26,44,0.590909091,Knicks,New York,240,20,24,5,39,44,20,4,4,13,17,120,17
22000905,PHI,1610612755,31,82,0.378,7,31,0.225806452,0.735,24,51,0.470588235,76ers,Philadelphia,240,25,34,10,31,41,15,11,4,17,20,94,-38
22000905,MIL,1610612749,49,95,0.516,18,40,0.45,0.667,31,55,0.563636364,Bucks,Milwaukee,240,16,24,16,39,55,33,10,4,15,28,132,38
22000906,IND,1610612754,40,96,0.417,10,32,0.3125,0.714,30,64,0.46875,Pacers,Indiana,240,25,35,9,30,39,28,10,9,4,21,115,6
22000906,DET,1610612765,39,96,0.406,10,34,0.294117647,0.808,29,62,0.467741935,Pistons,Detroit,240,21,26,15,47,62,26,3,7,18,25,109,-6
22000907,MIA,1610612748,36,80,0.45,14,37,0.378378378,0.833,22,43,0.511627907,Heat,Miami,240,20,24,6,31,37,22,11,2,10,12,106,5
22000907,CHI,1610612741,38,79,0.481,13,38,0.342105263,0.923,25,41,0.609756098,Bulls,Chicago,240,12,13,6,36,42,28,7,2,17,20,101,-5
22000908,LAL,1610612747,33,86,0.384,12,45,0.266666667,0.789,21,41,0.512195122,Lakers,Los Angeles,240,15,19,6,30,36,22,11,4,9,22,93,-15
22000908,DAL,1610612742,38,78,0.487,13,30,0.433333333,0.76,25,48,0.520833333,Mavericks,Dallas,240,19,25,10,41,51,26,3,2,16,17,108,15
22000909,UTA,1610612762,33,82,0.402,19,47,0.404255319,0.733,14,35,0.4,Jazz,Utah,240,11,15,9,36,45,24,9,5,20,21,96,-5
22000909,MIN,1610612750,40,92,0.435,9,38,0.236842105,0.6,31,54,0.574074074,Timberwolves,Minnesota,240,12,20,11,36,47,15,13,2,13,19,101,5
22000910,HOU,1610612745,41,82,0.5,15,40,0.375,0.679,26,42,0.619047619,Rockets,Houston,240,19,28,6,29,35,27,10,1,15,16,116,-13
22000910,DEN,1610612743,50,84,0.595,16,37,0.432432432,0.813,34,47,0.723404255,Nuggets,Denver,240,13,16,1,35,36,36,8,8,14,22,129,13
22000911,CHA,1610612766,47,93,0.505,21,43,0.488372093,0.909,26,50,0.52,Hornets,Charlotte,240,10,11,10,36,46,39,7,8,11,21,125,21
22000911,BOS,1610612738,34,88,0.386,14,41,0.341463415,0.846,20,47,0.425531915,Celtics,Boston,240,22,26,11,30,41,18,6,2,13,13,104,-21
22000912,PHX,1610612756,43,90,0.478,12,34,0.352941176,0.84,31,56,0.553571429,Suns,Phoenix,240,21,25,15,28,43,22,5,3,12,24,119,-9
22000912,BKN,1610612751,46,87,0.529,13,28,0.464285714,0.852,33,59,0.559322034,Nets,Brooklyn,240,23,27,11,33,44,30,6,4,10,17,128,9
22000913,MIL,1610612749,39,81,0.481,8,28,0.285714286,0.783,31,53,0.58490566,Bucks,Milwaukee,240,18,23,4,37,41,20,6,6,12,18,104,-7
22000913,ATL,1610612737,40,88,0.455,13,35,0.371428571,0.783,27,53,0.509433962,Hawks,Atlanta,240,18,23,5,39,44,23,6,1,9,20,111,7
22000914,ORL,1610612753,40,101,0.396,10,32,0.3125,0.786,30,69,0.434782609,Magic,Orlando,240,22,28,15,36,51,22,9,3,6,14,112,-19
22000914,IND,1610612754,50,91,0.549,15,32,0.46875,0.889,35,59,0.593220339,Pacers,Indiana,240,16,18,5,43,48,28,3,5,13,20,131,19
22000915,SAC,1610612758,41,86,0.477,14,37,0.378378378,0.773,27,49,0.551020408,Kings,Sacramento,240,17,22,6,31,37,22,8,5,10,15,113,-4
22000915,GSW,1610612744,46,95,0.484,14,36,0.388888889,0.733,32,59,0.542372881,Warriors,Golden State,240,11,15,17,36,53,30,5,3,16,16,117,4
22000916,DET,1610612765,40,84,0.476,9,26,0.346153846,0.733,31,58,0.534482759,Pistons,Detroit,240,11,15,8,39,47,22,9,8,14,16,100,14
22000916,ATL,1610612737,33,85,0.388,4,27,0.148148148,0.941,29,58,0.5,Hawks,Atlanta,240,16,17,9,36,45,19,10,4,16,17,86,-14
22000917,ORL,1610612753,36,76,0.474,11,25,0.44,0.833,25,51,0.490196078,Magic,Orlando,240,20,24,4,24,28,16,5,3,11,18,103,-11
22000917,LAL,1610612747,47,87,0.54,11,31,0.35483871,0.643,36,56,0.642857143,Lakers,Los Angeles,240,9,14,9,35,44,23,8,5,11,18,114,11
22000918,PHI,1610612755,47,86,0.547,14,31,0.451612903,0.722,33,55,0.6,76ers,Philadelphia,240,13,18,10,31,41,27,22,7,20,19,121,31
22000918,OKC,1610612760,35,78,0.449,7,30,0.233333333,0.565,28,48,0.583333333,Thunder,Oklahoma City,240,13,23,11,27,38,21,11,1,29,16,90,-31
22000919,WAS,1610612764,58,109,0.532,6,20,0.3,0.84,52,89,0.584269663,Wizards,Washington,265,21,25,18,32,50,26,4,8,8,23,143,-3
22000919,SAS,1610612759,55,103,0.534,6,17,0.352941176,0.857,49,86,0.569767442,Spurs,San Antonio,265,30,35,13,31,44,27,6,1,6,21,146,3
22000920,PHX,1610612756,45,83,0.542,14,34,0.411764706,0.824,31,49,0.632653061,Suns,Phoenix,240,14,17,5,32,37,23,5,6,8,13,118,8
22000920,NYK,1610612752,45,87,0.517,12,29,0.413793103,0.8,33,58,0.568965517,Knicks,New York,240,8,10,6,29,35,24,6,1,10,19,110,-8
22000921,TOR,1610612761,43,79,0.544,8,29,0.275862069,0.9,35,50,0.7,Raptors,Toronto,240,18,20,5,35,40,32,7,5,12,19,112,16
22000921,CLE,1610612739,36,83,0.434,10,38,0.263157895,0.875,26,45,0.577777778,Cavaliers,Cleveland,240,14,16,9,28,37,25,6,3,13,16,96,-16
22000922,MIA,1610612748,36,84,0.429,7,36,0.194444444,0.92,29,48,0.604166667,Heat,Miami,240,23,25,6,28,34,18,13,4,5,19,102,-8
22000922,CHI,1610612741,41,77,0.532,11,29,0.379310345,0.773,30,48,0.625,Bulls,Chicago,240,17,22,9,42,51,33,3,4,18,21,110,8
22000923,UTA,1610612762,37,95,0.389,16,57,0.280701754,0.737,21,38,0.552631579,Jazz,Utah,240,14,19,16,33,49,24,9,6,11,18,104,-1
22000923,MIN,1610612750,37,83,0.446,16,44,0.363636364,0.714,21,39,0.538461538,Timberwolves,Minnesota,240,15,21,8,40,48,29,7,4,16,21,105,1
22000924,NOP,1610612740,44,82,0.537,15,29,0.517241379,0.654,29,53,0.547169811,Pelicans,New Orleans,240,17,26,8,36,44,28,13,5,16,18,120,17
22000924,LAC,1610612746,36,90,0.4,14,45,0.311111111,1,22,45,0.488888889,Clippers,LA,240,17,17,13,31,44,20,5,5,18,23,103,-17
22000925,MEM,1610612763,34,81,0.42,4,32,0.125,0.774,30,49,0.612244898,Grizzlies,Memphis,240,24,31,6,39,45,20,8,6,16,22,96,-24
22000925,DEN,1610612743,45,94,0.479,11,33,0.333333333,0.864,34,61,0.557377049,Nuggets,Denver,240,19,22,8,40,48,25,8,3,11,20,120,24
22000926,SAC,1610612758,42,81,0.519,13,29,0.448275862,0.889,29,52,0.557692308,Kings,Sacramento,240,16,18,11,35,46,23,6,4,16,15,113,7
22000926,DAL,1610612742,43,92,0.467,12,42,0.285714286,0.571,31,50,0.62,Mavericks,Dallas,240,8,14,14,26,40,24,9,2,10,15,106,-7
22000927,OKC,1610612760,39,81,0.481,13,30,0.433333333,0.778,26,51,0.509803922,Thunder,Oklahoma City,240,28,36,10,41,51,25,5,3,27,24,119,4
22000927,BOS,1610612738,41,97,0.423,11,49,0.224489796,0.88,30,48,0.625,Celtics,Boston,240,22,25,8,31,39,21,16,7,14,26,115,-4
22000928,MIL,1610612749,47,93,0.505,9,35,0.257142857,0.786,38,58,0.655172414,Bucks,Milwaukee,240,11,14,9,39,48,28,13,3,15,24,114,10
22000928,CHA,1610612766,38,82,0.463,12,35,0.342857143,0.696,26,47,0.553191489,Hornets,Charlotte,240,16,23,7,31,38,26,6,7,17,17,104,-10
22000929,POR,1610612757,50,106,0.472,20,35,0.571428571,0.813,30,71,0.422535211,Trail Blazers,Portland,240,13,16,20,37,57,26,6,5,13,19,133,21
22000929,IND,1610612754,40,86,0.465,10,30,0.333333333,0.786,30,56,0.535714286,Pacers,Indiana,240,22,28,7,31,38,25,6,12,13,17,112,-21
22000930,TOR,1610612761,36,91,0.396,15,43,0.348837209,0.842,21,48,0.4375,Raptors,Toronto,240,16,19,15,32,47,24,5,3,13,19,103,-13
22000930,BKN,1610612751,40,83,0.482,18,45,0.4,1,22,38,0.578947368,Nets,Brooklyn,240,18,18,7,34,41,30,9,6,10,20,116,13
22000931,MIN,1610612750,45,93,0.484,10,38,0.263157895,0.56,35,55,0.636363636,Timberwolves,Minnesota,240,14,25,12,36,48,29,10,6,14,20,114,7
22000931,HOU,1610612745,42,86,0.488,7,31,0.225806452,0.727,35,55,0.636363636,Rockets,Houston,240,16,22,8,37,45,24,9,4,17,22,107,-7
22000932,GSW,1610612744,34,84,0.405,16,43,0.372093023,0.792,18,41,0.43902439,Warriors,Golden State,240,19,24,10,33,43,25,11,5,18,18,103,-30
22000932,DAL,1610612742,48,92,0.522,18,35,0.514285714,0.864,30,57,0.526315789,Mavericks,Dallas,240,19,22,9,41,50,21,9,4,13,19,133,30
22000933,ORL,1610612753,43,85,0.506,10,29,0.344827586,0.65,33,56,0.589285714,Magic,Orlando,240,13,20,9,40,49,26,9,7,15,21,109,5
22000933,CLE,1610612739,37,92,0.402,12,44,0.272727273,0.75,25,48,0.520833333,Cavaliers,Cleveland,240,18,24,13,32,45,30,12,3,11,15,104,-5
22000934,PHI,1610612755,48,89,0.539,16,36,0.444444444,0.682,32,53,0.603773585,76ers,Philadelphia,240,15,22,11,35,46,29,12,10,7,22,127,44
22000934,ATL,1610612737,27,81,0.333,6,19,0.315789474,0.793,21,62,0.338709677,Hawks,Atlanta,240,23,29,17,30,47,17,3,3,14,18,83,-44
22000935,WAS,1610612764,47,90,0.522,6,18,0.333333333,0.762,41,72,0.569444444,Wizards,Washington,240,16,21,10,40,50,24,6,4,13,20,116,9
22000935,LAL,1610612747,42,96,0.438,10,34,0.294117647,0.619,32,62,0.516129032,Lakers,Los Angeles,240,13,21,13,28,41,31,10,8,10,20,107,-9
22000936,CHA,1610612766,37,87,0.425,13,35,0.371428571,0.75,24,52,0.461538462,Hornets,Charlotte,240,24,32,11,22,33,29,7,5,11,18,111,-9
22000936,BOS,1610612738,44,92,0.478,15,40,0.375,0.773,29,52,0.557692308,Celtics,Boston,240,17,22,19,35,54,26,9,8,14,24,120,9
22000937,NYK,1610612752,42,91,0.462,12,27,0.444444444,0.895,30,64,0.46875,Knicks,New York,240,17,19,9,32,41,27,10,9,4,16,113,19
22000937,CHI,1610612741,39,85,0.459,10,29,0.344827586,0.6,29,56,0.517857143,Bulls,Chicago,240,6,10,7,36,43,29,2,4,14,12,94,-19
22000938,SAS,1610612759,41,88,0.466,10,32,0.3125,0.792,31,56,0.553571429,Spurs,San Antonio,240,19,24,7,33,40,26,6,3,9,20,111,-5
22000938,MIA,1610612748,43,85,0.506,9,25,0.36,0.875,34,60,0.566666667,Heat,Miami,240,21,24,10,38,48,26,4,1,12,23,116,5
22000939,POR,1610612757,45,92,0.489,15,40,0.375,0.893,30,52,0.576923077,Trail Blazers,Portland,240,25,28,11,40,51,23,7,6,10,20,130,21
22000939,MEM,1610612763,37,88,0.42,9,32,0.28125,0.867,28,56,0.5,Grizzlies,Memphis,240,26,30,8,36,44,26,7,6,11,21,109,-21
22000940,NOP,1610612740,43,87,0.494,12,30,0.4,0.737,31,57,0.543859649,Pelicans,New Orleans,240,14,19,6,36,42,27,13,5,21,24,112,-2
22000940,DEN,1610612743,43,85,0.506,10,32,0.3125,0.783,33,53,0.622641509,Nuggets,Denver,240,18,23,3,35,38,26,14,8,18,17,114,2
22000941,PHX,1610612756,43,91,0.473,13,37,0.351351351,0.769,30,54,0.555555556,Suns,Phoenix,240,10,13,15,30,45,23,9,4,10,11,109,8
22000941,LAC,1610612746,41,80,0.512,12,31,0.387096774,0.778,29,49,0.591836735,Clippers,LA,240,7,9,5,31,36,24,8,0,14,16,101,-8
22000942,UTA,1610612762,55,86,0.64,24,41,0.585365854,0.952,31,45,0.688888889,Jazz,Utah,240,20,21,8,39,47,36,4,9,13,15,154,49
22000942,SAC,1610612758,42,87,0.483,7,21,0.333333333,0.824,35,66,0.53030303,Kings,Sacramento,240,14,17,3,21,24,24,8,6,12,19,105,-49
22000943,DET,1610612765,36,71,0.507,10,29,0.344827586,0.676,26,42,0.619047619,Pistons,Detroit,240,23,34,3,36,39,26,7,5,18,23,105,-10
22000943,DAL,1610612742,40,89,0.449,13,30,0.433333333,0.957,27,59,0.457627119,Mavericks,Dallas,240,22,23,8,27,35,22,6,2,11,20,115,10
22000944,IND,1610612754,41,96,0.427,11,39,0.282051282,0.952,30,57,0.526315789,Pacers,Indiana,240,20,21,7,31,38,23,8,6,10,23,113,-17
22000944,BKN,1610612751,47,89,0.528,12,35,0.342857143,0.857,35,54,0.648148148,Nets,Brooklyn,240,24,28,8,42,50,35,3,5,13,19,130,17
22000945,MIL,1610612749,49,93,0.527,16,39,0.41025641,0.88,33,54,0.611111111,Bucks,Milwaukee,240,22,25,8,30,38,27,12,5,14,21,136,-7
22000945,HOU,1610612745,49,98,0.5,25,46,0.543478261,0.833,24,52,0.461538462,Rockets,Houston,240,20,24,16,36,52,23,6,6,18,23,143,7
22000946,MIN,1610612750,43,94,0.457,20,41,0.487804878,0.69,23,53,0.433962264,Timberwolves,Minnesota,240,20,29,16,41,57,31,5,2,13,21,126,12
22000946,GSW,1610612744,42,85,0.494,15,38,0.394736842,0.714,27,47,0.574468085,Warriors,Golden State,240,15,21,4,30,34,28,10,7,10,21,114,-12
22000947,OKC,1610612760,34,89,0.382,11,39,0.282051282,0.8,23,50,0.46,Thunder,Oklahoma City,240,16,20,12,41,53,18,6,4,22,21,95,-14
22000947,NOP,1610612740,45,101,0.446,5,29,0.172413793,0.737,40,72,0.555555556,Pelicans,New Orleans,240,14,19,15,41,56,26,11,6,12,22,109,14
22000948,TOR,1610612761,40,83,0.482,16,32,0.5,0.833,24,51,0.470588235,Raptors,Toronto,240,15,18,7,29,36,27,10,6,15,19,111,-10
22000948,DEN,1610612743,44,93,0.473,12,35,0.342857143,0.808,32,58,0.551724138,Nuggets,Denver,240,21,26,14,33,47,22,6,7,11,16,121,10
22000949,PHI,1610612755,47,101,0.465,10,28,0.357142857,0.846,37,73,0.506849315,76ers,Philadelphia,240,22,26,18,32,50,27,8,6,8,21,126,22
22000949,ATL,1610612737,36,82,0.439,10,28,0.357142857,0.786,26,54,0.481481481,Hawks,Atlanta,240,22,28,12,34,46,19,3,8,16,23,104,-22
22000950,SAS,1610612759,49,92,0.533,11,24,0.458333333,0.816,38,68,0.558823529,Spurs,San Antonio,265,31,38,8,35,43,29,6,1,11,27,140,-3
22000950,BOS,1610612738,49,105,0.467,18,38,0.473684211,0.75,31,67,0.462686567,Celtics,Boston,265,27,36,17,35,52,31,7,7,13,26,143,3
22000951,WAS,1610612764,46,92,0.5,8,18,0.444444444,0.846,38,74,0.513513514,Wizards,Washington,240,22,26,11,35,46,31,14,3,12,19,122,29
22000951,CLE,1610612739,34,82,0.415,7,33,0.212121212,0.643,27,49,0.551020408,Cavaliers,Cleveland,240,18,28,14,32,46,19,6,4,24,17,93,-29
22000952,POR,1610612757,47,91,0.516,16,36,0.444444444,0.9,31,55,0.563636364,Trail Blazers,Portland,240,18,20,8,42,50,24,3,2,10,17,128,19
22000952,BKN,1610612751,40,95,0.421,13,41,0.317073171,0.842,27,54,0.5,Nets,Brooklyn,240,16,19,11,31,42,20,6,3,8,18,109,-19
22000953,ORL,1610612753,27,86,0.314,6,26,0.230769231,0.75,21,60,0.35,Magic,Orlando,240,15,20,12,44,56,16,4,6,20,19,75,-17
22000953,MEM,1610612763,34,99,0.343,11,39,0.282051282,0.813,23,60,0.383333333,Grizzlies,Memphis,240,13,16,15,42,57,25,10,8,8,15,92,17
22000954,MIL,1610612749,42,90,0.467,9,25,0.36,0.75,33,65,0.507692308,Bucks,Milwaukee,240,15,20,8,43,51,24,5,5,10,19,108,10
22000954,CHI,1610612741,37,96,0.385,10,33,0.303030303,0.667,27,63,0.428571429,Bulls,Chicago,240,14,21,14,36,50,23,5,5,10,18,98,-10
22000955,UTA,1610612762,35,80,0.438,14,39,0.358974359,0.889,21,41,0.512195122,Jazz,Utah,240,16,18,8,28,36,22,8,5,13,17,100,-21
22000955,PHX,1610612756,48,88,0.545,11,33,0.333333333,0.737,37,55,0.672727273,Suns,Phoenix,240,14,19,8,36,44,27,7,7,11,14,121,21
22000956,SAC,1610612758,39,86,0.453,12,33,0.363636364,0.909,27,53,0.509433962,Kings,Sacramento,240,20,22,11,26,37,29,10,3,17,16,110,4
22000956,LAL,1610612747,42,83,0.506,7,28,0.25,0.714,35,55,0.636363636,Lakers,Los Angeles,240,15,21,11,32,43,24,9,12,21,17,106,-4
22000957,DET,1610612765,35,91,0.385,13,37,0.351351351,0.647,22,54,0.407407407,Pistons,Detroit,240,11,17,12,31,43,27,6,7,10,16,94,-13
22000957,CHA,1610612766,42,87,0.483,14,37,0.378378378,0.45,28,50,0.56,Hornets,Charlotte,240,9,20,14,40,54,24,8,15,13,16,107,13
22000958,HOU,1610612745,32,89,0.36,9,42,0.214285714,0.636,23,47,0.489361702,Rockets,Houston,240,14,22,10,39,49,20,9,3,18,18,87,-26
22000958,GSW,1610612744,39,84,0.464,18,46,0.391304348,0.708,21,38,0.552631579,Warriors,Golden State,240,17,24,4,46,50,32,10,8,17,18,113,26
22000959,CHI,1610612741,40,85,0.471,6,24,0.25,0.647,34,61,0.557377049,Bulls,Chicago,240,11,17,8,31,39,22,11,0,13,22,97,-11
22000959,ATL,1610612737,37,74,0.5,14,36,0.388888889,0.769,23,38,0.605263158,Hawks,Atlanta,240,20,26,6,38,44,19,11,5,14,21,108,11
22000960,MIA,1610612748,47,87,0.54,18,36,0.5,0.8,29,51,0.568627451,Heat,Miami,240,12,15,10,27,37,30,12,1,8,16,124,17
22000960,CLE,1610612739,37,74,0.5,20,40,0.5,0.765,17,34,0.5,Cavaliers,Cleveland,240,13,17,9,30,39,30,3,4,18,17,107,-17
22000961,ORL,1610612753,38,85,0.447,11,25,0.44,0.893,27,60,0.45,Magic,Orlando,240,25,28,6,31,37,20,10,5,10,17,112,1
22000961,MEM,1610612763,44,96,0.458,10,29,0.344827586,0.619,34,67,0.507462687,Grizzlies,Memphis,240,13,21,17,38,55,21,6,10,16,20,111,-1
22000962,NOP,1610612740,47,92,0.511,14,36,0.388888889,0.696,33,56,0.589285714,Pelicans,New Orleans,265,32,46,14,38,52,34,8,5,21,20,140,4
22000962,MIN,1610612750,48,106,0.453,15,48,0.3125,0.781,33,58,0.568965517,Timberwolves,Minnesota,265,25,32,13,38,51,35,17,5,16,30,136,-4
22000963,OKC,1610612760,38,111,0.342,8,38,0.210526316,0.478,30,73,0.410958904,Thunder,Oklahoma City,240,11,23,21,27,48,23,8,4,14,15,95,-57
22000963,IND,1610612754,57,87,0.655,21,33,0.636363636,0.773,36,54,0.666666667,Pacers,Indiana,240,17,22,3,50,53,41,7,11,17,22,152,57
22000964,WAS,1610612764,47,91,0.516,6,19,0.315789474,0.774,41,72,0.569444444,Wizards,Washington,240,24,31,14,32,46,19,5,3,10,23,124,-1
22000964,DAL,1610612742,47,87,0.54,17,38,0.447368421,0.636,30,49,0.612244898,Mavericks,Dallas,240,14,22,7,29,36,31,6,4,11,25,125,1
22000965,UTA,1610612762,37,78,0.474,17,41,0.414634146,0.833,20,37,0.540540541,Jazz,Utah,240,15,18,9,40,49,20,3,3,20,15,106,4
22000965,TOR,1610612761,42,94,0.447,12,33,0.363636364,0.667,30,61,0.491803279,Raptors,Toronto,240,6,9,11,28,39,26,12,3,10,15,102,-4
22000966,LAC,1610612746,36,83,0.434,14,34,0.411764706,0.75,22,49,0.448979592,Clippers,LA,240,18,24,10,29,39,21,8,3,6,19,104,-6
22000966,DEN,1610612743,39,80,0.487,12,32,0.375,0.952,27,48,0.5625,Nuggets,Denver,240,20,21,8,36,44,26,2,4,10,23,110,6
22000967,MIL,1610612749,48,98,0.49,15,37,0.405405405,0.5,33,61,0.540983607,Bucks,Milwaukee,240,6,12,8,37,45,19,9,11,10,18,117,3
22000967,BKN,1610612751,41,96,0.427,17,42,0.404761905,0.882,24,54,0.444444444,Nets,Brooklyn,240,15,17,14,39,53,18,5,1,16,11,114,-3
22000968,POR,1610612757,44,85,0.518,19,38,0.5,0.846,25,47,0.531914894,Trail Blazers,Portland,240,22,26,3,33,36,27,8,5,9,18,129,10
22000968,BOS,1610612738,43,89,0.483,20,39,0.512820513,0.867,23,50,0.46,Celtics,Boston,240,13,15,10,35,45,29,3,6,18,21,119,-10
22000969,MIA,1610612748,45,88,0.511,11,38,0.289473684,0.741,34,50,0.68,Heat,Miami,240,20,27,11,31,42,30,10,6,11,22,121,10
22000969,CHA,1610612766,40,81,0.494,14,33,0.424242424,0.773,26,48,0.541666667,Hornets,Charlotte,240,17,22,8,31,39,30,9,1,14,20,111,-10
22000970,SAC,1610612758,45,81,0.556,11,28,0.392857143,0.625,34,53,0.641509434,Kings,Sacramento,240,10,16,8,30,38,27,9,1,19,26,111,12
22000970,DAL,1610612742,34,81,0.42,6,35,0.171428571,0.806,28,46,0.608695652,Mavericks,Dallas,240,25,31,13,27,40,16,12,4,16,16,99,-12
22000971,NYK,1610612752,45,86,0.523,18,35,0.514285714,0.875,27,51,0.529411765,Knicks,New York,240,14,16,6,32,38,22,10,1,13,21,122,25
22000971,HOU,1610612745,34,79,0.43,8,35,0.228571429,0.656,26,44,0.590909091,Rockets,Houston,240,21,32,14,33,47,19,6,5,17,18,97,-25
22000972,PHX,1610612756,45,84,0.536,12,31,0.387096774,0.778,33,53,0.622641509,Suns,Phoenix,240,21,27,8,31,39,27,9,7,10,17,123,3
22000972,OKC,1610612760,45,92,0.489,13,30,0.433333333,0.708,32,62,0.516129032,Thunder,Oklahoma City,240,17,24,17,30,47,23,7,3,15,22,120,-3
22000973,SAS,1610612759,43,96,0.448,12,31,0.387096774,0.765,31,65,0.476923077,Spurs,San Antonio,265,13,17,10,38,48,20,9,5,13,25,111,-2
22000973,PHI,1610612755,42,94,0.447,11,30,0.366666667,0.72,31,64,0.484375,76ers,Philadelphia,265,18,25,13,36,49,23,7,9,12,19,113,2
22000974,TOR,1610612761,42,94,0.447,15,38,0.394736842,0.71,27,56,0.482142857,Raptors,Toronto,240,22,31,13,36,49,24,11,4,12,23,121,7
22000974,LAL,1610612747,41,85,0.482,11,29,0.379310345,0.677,30,56,0.535714286,Lakers,Los Angeles,240,21,31,7,37,44,32,7,6,14,22,114,-7
22000975,ORL,1610612753,45,88,0.511,10,23,0.434782609,0.76,35,65,0.538461538,Magic,Orlando,240,19,25,9,39,48,27,6,3,10,18,119,7
22000975,DET,1610612765,44,93,0.473,11,35,0.314285714,0.722,33,58,0.568965517,Pistons,Detroit,240,13,18,12,30,42,24,8,4,11,19,112,-7
22000976,WAS,1610612764,63,103,0.612,9,22,0.409090909,0.792,54,81,0.666666667,Wizards,Washington,240,19,24,9,35,44,50,10,7,16,19,154,13
22000976,IND,1610612754,53,107,0.495,14,27,0.518518519,0.84,39,80,0.4875,Pacers,Indiana,240,21,25,14,31,45,28,8,6,17,17,141,-13
22000977,NOP,1610612740,39,90,0.433,5,25,0.2,0.781,34,65,0.523076923,Pelicans,New Orleans,240,25,32,13,34,47,20,6,4,16,8,108,-15
22000977,GSW,1610612744,47,88,0.534,17,44,0.386363636,0.857,30,44,0.681818182,Warriors,Golden State,240,12,14,5,33,38,31,9,8,14,28,123,15
22000978,POR,1610612757,43,95,0.453,17,41,0.414634146,0.786,26,54,0.481481481,Trail Blazers,Portland,240,11,14,8,31,39,25,7,4,8,15,114,-9
22000978,ATL,1610612737,44,84,0.524,20,41,0.487804878,0.833,24,43,0.558139535,Hawks,Atlanta,240,15,18,5,44,49,32,6,3,11,18,123,9
22000979,PHI,1610612755,40,75,0.533,11,28,0.392857143,0.714,29,47,0.617021277,76ers,Philadelphia,240,15,21,7,37,44,23,11,6,16,13,106,12
22000979,CHI,1610612741,36,87,0.414,11,34,0.323529412,0.786,25,53,0.471698113,Bulls,Chicago,240,11,14,12,28,40,25,7,2,15,15,94,-12
22000980,NYK,1610612752,45,89,0.506,14,27,0.518518519,0.778,31,62,0.5,Knicks,New York,240,14,18,8,37,45,19,6,8,8,21,118,14
22000980,MEM,1610612763,34,86,0.395,16,41,0.390243902,0.833,18,45,0.4,Grizzlies,Memphis,240,20,24,13,33,46,26,7,4,12,14,104,-14
22000981,UTA,1610612762,44,88,0.5,11,36,0.305555556,0.688,33,52,0.634615385,Jazz,Utah,240,11,16,14,36,50,22,10,5,15,11,110,11
22000981,SAS,1610612759,42,90,0.467,5,18,0.277777778,1,37,72,0.513888889,Spurs,San Antonio,240,10,10,8,29,37,25,10,4,13,13,99,-11
22000982,LAL,1610612747,32,73,0.438,13,30,0.433333333,0.696,19,43,0.441860465,Lakers,Los Angeles,240,16,23,7,36,43,18,5,8,20,20,93,4
22000982,DEN,1610612743,36,82,0.439,6,24,0.25,0.688,30,58,0.517241379,Nuggets,Denver,240,11,16,6,35,41,22,10,7,12,24,89,-4
22000983,PHX,1610612756,55,105,0.524,12,31,0.387096774,0.923,43,74,0.581081081,Suns,Phoenix,265,12,13,12,36,48,35,10,11,7,26,134,16
22000983,CLE,1610612739,41,90,0.456,13,29,0.448275862,0.852,28,61,0.459016393,Cavaliers,Cleveland,265,23,27,9,33,42,29,3,3,17,13,118,-16
22000984,DET,1610612765,39,85,0.459,9,32,0.28125,0.6,30,53,0.566037736,Pistons,Detroit,240,12,20,10,36,46,21,3,3,13,21,99,-3
22000984,CHA,1610612766,38,93,0.409,8,31,0.258064516,0.75,30,62,0.483870968,Hornets,Charlotte,240,18,24,16,35,51,23,8,5,8,23,102,3
22000985,MIL,1610612749,44,98,0.449,14,37,0.378378378,0.815,30,61,0.491803279,Bucks,Milwaukee,240,22,27,15,40,55,23,7,3,12,21,124,6
22000985,BKN,1610612751,41,84,0.488,20,43,0.465116279,0.615,21,41,0.512195122,Nets,Brooklyn,240,16,26,6,33,39,21,6,6,13,25,118,-6
22000986,MIA,1610612748,39,84,0.464,18,41,0.43902439,0.81,21,43,0.488372093,Heat,Miami,240,17,21,8,31,39,30,9,2,12,17,113,-14
22000986,DAL,1610612742,46,87,0.529,22,48,0.458333333,0.722,24,39,0.615384615,Mavericks,Dallas,240,13,18,12,32,44,26,6,4,13,17,127,14
22000987,NOP,1610612740,39,97,0.402,12,30,0.4,0.818,27,67,0.402985075,Pelicans,New Orleans,240,18,22,14,43,57,28,10,3,12,9,108,5
22000987,GSW,1610612744,39,93,0.419,20,53,0.377358491,0.714,19,40,0.475,Warriors,Golden State,240,5,7,8,40,48,22,7,9,18,17,103,-5
22000988,SAC,1610612758,39,95,0.411,12,43,0.279069767,0.813,27,52,0.519230769,Kings,Sacramento,240,13,16,9,40,49,25,6,10,12,19,103,4
22000988,OKC,1610612760,35,98,0.357,11,36,0.305555556,0.72,24,62,0.387096774,Thunder,Oklahoma City,240,18,25,17,40,57,21,5,4,9,14,99,-4
22000989,TOR,1610612761,40,87,0.46,12,35,0.342857143,0.615,28,52,0.538461538,Raptors,Toronto,240,8,13,7,30,37,22,10,3,12,15,100,-5
22000989,LAC,1610612746,39,75,0.52,15,34,0.441176471,0.923,24,41,0.585365854,Clippers,LA,240,12,13,4,38,42,28,7,5,18,14,105,5
22000990,ORL,1610612753,33,85,0.388,6,25,0.24,0.857,27,60,0.45,Magic,Orlando,240,24,28,10,35,45,13,7,7,17,11,96,-36
22000990,BOS,1610612738,51,96,0.531,21,45,0.466666667,0.75,30,51,0.588235294,Celtics,Boston,240,9,12,9,36,45,28,8,9,11,23,132,36
22000991,POR,1610612757,53,92,0.576,16,33,0.484848485,0.76,37,59,0.627118644,Trail Blazers,Portland,240,19,25,11,43,54,26,7,9,10,20,141,36
22000991,CLE,1610612739,37,92,0.402,13,38,0.342105263,0.692,24,54,0.444444444,Cavaliers,Cleveland,240,18,26,12,30,42,23,9,3,8,18,105,-36
22000992,PHX,1610612756,33,79,0.418,12,32,0.375,0.862,21,47,0.446808511,Suns,Phoenix,240,25,29,10,20,30,19,9,3,9,16,103,-32
22000992,ATL,1610612737,53,84,0.631,13,26,0.5,0.889,40,58,0.689655172,Hawks,Atlanta,240,16,18,9,37,46,35,8,6,11,21,135,32
22000993,SAC,1610612758,43,95,0.453,8,32,0.25,0.714,35,63,0.555555556,Kings,Sacramento,240,10,14,12,36,48,21,16,7,11,14,104,11
22000993,IND,1610612754,36,83,0.434,9,25,0.36,0.706,27,58,0.465517241,Pacers,Indiana,240,12,17,10,38,48,26,8,6,22,13,93,-11
22000994,PHI,1610612755,50,94,0.532,15,35,0.428571429,0.909,35,59,0.593220339,76ers,Philadelphia,240,20,22,11,36,47,26,10,6,9,16,135,20
22000994,HOU,1610612745,42,93,0.452,17,45,0.377777778,0.778,25,48,0.520833333,Rockets,Houston,240,14,18,12,26,38,28,6,5,13,16,115,-20
22000995,NYK,1610612752,33,86,0.384,13,35,0.371428571,0.667,20,51,0.392156863,Knicks,New York,240,18,27,6,36,42,18,6,10,15,24,97,-16
22000995,DEN,1610612743,37,97,0.381,12,39,0.307692308,0.818,25,58,0.431034483,Nuggets,Denver,240,27,33,17,46,63,23,13,7,13,24,113,16
22000996,UTA,1610612762,49,88,0.557,18,41,0.43902439,0.714,31,47,0.659574468,Jazz,Utah,240,10,14,7,46,53,24,5,2,14,20,126,32
22000996,SAS,1610612759,37,92,0.402,7,23,0.304347826,0.65,30,69,0.434782609,Spurs,San Antonio,240,13,20,9,26,35,22,7,5,7,13,94,-32
22000997,WAS,1610612764,41,94,0.436,13,30,0.433333333,0.837,28,64,0.4375,Wizards,Washington,265,36,43,11,36,47,29,4,6,13,22,131,2
22000997,TOR,1610612761,47,105,0.448,14,38,0.368421053,0.778,33,67,0.492537313,Raptors,Toronto,265,21,27,18,32,50,23,9,5,12,30,129,-2
22000998,DAL,1610612742,40,89,0.449,15,34,0.441176471,0.692,25,55,0.454545455,Mavericks,Dallas,240,18,26,12,39,51,23,10,3,12,15,113,4
22000998,BKN,1610612751,41,95,0.432,13,37,0.351351351,0.933,28,58,0.482758621,Nets,Brooklyn,240,14,15,10,41,51,18,8,4,13,18,109,-4
22000999,MEM,1610612763,38,89,0.427,10,37,0.27027027,0.647,28,52,0.538461538,Grizzlies,Memphis,240,11,17,12,30,42,25,7,5,15,14,97,-14
22000999,DET,1610612765,44,83,0.53,11,28,0.392857143,0.857,33,55,0.6,Pistons,Detroit,240,12,14,5,34,39,24,9,6,11,18,111,14
22001000,IND,1610612754,54,87,0.621,8,20,0.4,0.895,46,67,0.686567164,Pacers,Indiana,240,17,19,4,32,36,35,11,4,15,19,133,7
22001000,ATL,1610612737,48,94,0.511,15,37,0.405405405,0.833,33,57,0.578947368,Hawks,Atlanta,240,15,18,10,24,34,27,8,6,12,17,126,-7
22001001,OKC,1610612760,36,88,0.409,9,39,0.230769231,0.8,27,49,0.551020408,Thunder,Oklahoma City,240,16,20,5,34,39,21,9,1,9,19,97,-21
22001001,GSW,1610612744,42,86,0.488,19,47,0.404255319,0.833,23,39,0.58974359,Warriors,Golden State,240,15,18,7,42,49,36,4,1,13,19,118,21
22001002,LAL,1610612747,33,87,0.379,10,36,0.277777778,0.621,23,51,0.450980392,Lakers,Los Angeles,240,18,29,11,23,34,21,8,6,10,23,94,-24
22001002,LAC,1610612746,41,77,0.532,13,31,0.419354839,0.885,28,46,0.608695652,Clippers,LA,240,23,26,9,39,48,23,4,5,22,25,118,24
22001003,PHI,1610612755,38,85,0.447,15,35,0.428571429,0.818,23,50,0.46,76ers,Philadelphia,240,18,22,10,41,51,27,5,6,15,19,109,2
22001003,NOP,1610612740,41,101,0.406,9,36,0.25,0.727,32,65,0.492307692,Pelicans,New Orleans,240,16,22,16,36,52,26,12,6,10,21,107,-2
22001004,ORL,1610612753,41,98,0.418,9,30,0.3,0.75,32,68,0.470588235,Magic,Orlando,240,21,28,14,33,47,19,6,7,6,24,112,-10
22001004,CHA,1610612766,44,89,0.494,9,33,0.272727273,0.758,35,56,0.625,Hornets,Charlotte,240,25,33,11,40,51,28,5,4,11,23,122,10
22001005,MIN,1610612750,41,85,0.482,10,37,0.27027027,0.667,31,48,0.645833333,Timberwolves,Minnesota,240,20,30,9,32,41,27,7,4,16,24,112,-9
22001005,MIA,1610612748,44,87,0.506,13,32,0.40625,0.741,31,55,0.563636364,Heat,Miami,240,20,27,8,29,37,27,9,2,14,22,121,9
22001006,MIL,1610612749,51,95,0.537,19,46,0.413043478,0.87,32,49,0.653061224,Bucks,Milwaukee,240,20,23,13,40,53,30,8,5,17,14,141,8
22001006,HOU,1610612745,48,96,0.5,25,53,0.471698113,0.667,23,43,0.534883721,Rockets,Houston,240,12,18,7,30,37,36,10,5,16,21,133,-8
22001007,DAL,1610612742,41,83,0.494,10,32,0.3125,0.818,31,51,0.607843137,Mavericks,Dallas,240,18,22,9,36,45,21,7,7,9,22,110,20
22001007,CLE,1610612739,32,83,0.386,6,29,0.206896552,0.769,26,54,0.481481481,Cavaliers,Cleveland,240,20,26,11,32,43,17,6,0,14,18,90,-20
22001008,UTA,1610612762,43,89,0.483,21,46,0.456521739,0.87,22,43,0.511627907,Jazz,Utah,240,20,23,9,29,38,27,9,3,10,20,127,7
22001008,DEN,1610612743,43,83,0.518,17,38,0.447368421,0.85,26,45,0.577777778,Nuggets,Denver,240,17,20,9,29,38,31,8,3,17,16,120,-7
22001009,PHX,1610612756,43,92,0.467,18,41,0.43902439,0.96,25,51,0.490196078,Suns,Phoenix,240,24,25,7,38,45,26,5,3,5,17,128,23
22001009,NYK,1610612752,38,84,0.452,11,32,0.34375,0.783,27,52,0.519230769,Knicks,New York,240,18,23,6,35,41,24,2,4,13,25,105,-23
22001010,POR,1610612757,37,88,0.42,12,37,0.324324324,0.952,25,51,0.490196078,Trail Blazers,Portland,240,20,21,6,38,44,22,6,2,8,20,106,5
22001010,LAL,1610612747,37,89,0.416,11,30,0.366666667,0.727,26,59,0.440677966,Lakers,Los Angeles,240,16,22,10,39,49,19,2,4,14,20,101,-5
22001011,SAS,1610612759,46,89,0.517,4,22,0.181818182,0.895,42,67,0.626865672,Spurs,San Antonio,240,17,19,7,37,44,20,8,7,13,12,113,9
22001011,SAC,1610612758,41,84,0.488,13,32,0.40625,0.6,28,52,0.538461538,Kings,Sacramento,240,9,15,4,31,35,27,10,3,16,19,104,-9
22001012,WAS,1610612764,49,110,0.445,9,32,0.28125,0.867,40,78,0.512820513,Wizards,Washington,265,26,30,15,45,60,26,7,9,15,24,133,1
22001012,IND,1610612754,50,104,0.481,7,29,0.24137931,0.833,43,75,0.573333333,Pacers,Indiana,265,25,30,8,41,49,33,11,5,13,24,132,-1
22001013,PHI,1610612755,41,84,0.488,9,30,0.3,0.871,32,54,0.592592593,76ers,Philadelphia,240,27,31,9,35,44,22,11,4,10,18,118,14
22001013,DET,1610612765,41,84,0.488,11,34,0.323529412,0.688,30,50,0.6,Pistons,Detroit,240,11,16,10,34,44,22,5,7,16,25,104,-14
22001014,TOR,1610612761,36,94,0.383,10,32,0.3125,0.708,26,62,0.419354839,Raptors,Toronto,240,17,24,13,33,46,18,10,2,11,21,99,-10
22001014,MEM,1610612763,38,85,0.447,14,43,0.325581395,0.731,24,42,0.571428571,Grizzlies,Memphis,240,19,26,14,42,56,24,7,8,17,21,109,10
22001015,DEN,1610612743,42,92,0.457,14,41,0.341463415,0.913,28,51,0.549019608,Nuggets,Denver,240,21,23,10,23,33,21,8,1,12,23,119,-6
22001015,BKN,1610612751,41,66,0.621,16,31,0.516129032,0.818,25,35,0.714285714,Nets,Brooklyn,240,27,33,2,33,35,27,10,5,17,24,125,6
22001016,UTA,1610612762,45,85,0.529,15,38,0.394736842,0.905,30,47,0.638297872,Jazz,Utah,240,19,21,7,42,49,28,7,4,17,13,124,8
22001016,HOU,1610612745,43,98,0.439,18,51,0.352941176,0.706,25,47,0.531914894,Rockets,Houston,240,12,17,9,31,40,25,11,3,8,15,116,-8
22001017,OKC,1610612760,38,94,0.404,9,37,0.243243243,0.6,29,57,0.50877193,Thunder,Oklahoma City,240,12,20,11,30,41,21,10,1,13,16,97,-39
22001017,GSW,1610612744,47,81,0.58,27,54,0.5,0.833,20,27,0.740740741,Warriors,Golden State,240,15,18,2,44,46,31,5,4,18,19,136,39
22001018,SAS,1610612759,37,93,0.398,8,30,0.266666667,0.87,29,63,0.46031746,Spurs,San Antonio,240,20,23,7,33,40,17,6,5,7,24,102,-22
22001018,POR,1610612757,45,97,0.464,12,34,0.352941176,0.733,33,63,0.523809524,Trail Blazers,Portland,240,22,30,18,45,63,24,3,5,8,15,124,22
22001019,NYK,1610612752,42,90,0.467,13,32,0.40625,1,29,58,0.5,Knicks,New York,240,9,9,8,37,45,25,7,5,10,17,106,6
22001019,LAC,1610612746,37,86,0.43,12,35,0.342857143,0.875,25,51,0.490196078,Clippers,LA,240,14,16,7,36,43,24,5,1,13,12,100,-6
22001020,NOP,1610612740,45,96,0.469,12,37,0.324324324,0.455,33,59,0.559322034,Pelicans,New Orleans,240,10,22,16,35,51,26,11,9,16,20,112,2
22001020,CHA,1610612766,42,95,0.442,13,37,0.351351351,0.722,29,58,0.5,Hornets,Charlotte,240,13,18,11,35,46,22,6,8,17,19,110,-2
22001021,DAL,1610612742,50,93,0.538,15,39,0.384615385,0.818,35,54,0.648148148,Mavericks,Dallas,240,9,11,8,34,42,33,9,7,10,24,124,27
22001021,CLE,1610612739,33,86,0.384,11,31,0.35483871,0.645,22,55,0.4,Cavaliers,Cleveland,240,20,31,10,28,38,18,5,2,14,12,97,-27
22001022,ORL,1610612753,36,91,0.396,9,36,0.25,0.682,27,55,0.490909091,Magic,Orlando,240,15,22,10,35,45,20,5,5,13,20,96,-32
22001022,MIN,1610612750,47,97,0.485,16,45,0.355555556,0.75,31,52,0.596153846,Timberwolves,Minnesota,240,18,24,12,45,57,30,5,9,10,20,128,32
22001023,DET,1610612765,36,79,0.456,11,27,0.407407407,0.591,25,52,0.480769231,Pistons,Detroit,240,13,22,5,32,37,22,4,4,13,14,96,-12
22001023,CHI,1610612741,43,84,0.512,12,32,0.375,0.714,31,52,0.596153846,Bulls,Chicago,240,10,14,5,38,43,27,6,3,8,22,108,12
22001024,PHX,1610612756,39,73,0.534,11,25,0.44,0.84,28,48,0.583333333,Suns,Phoenix,240,21,25,3,29,32,23,8,6,15,29,110,-13
22001024,LAL,1610612747,39,80,0.487,13,30,0.433333333,0.78,26,50,0.52,Lakers,Los Angeles,240,32,41,14,27,41,24,11,3,13,21,123,13
22001025,SAC,1610612758,45,85,0.529,16,36,0.444444444,0.833,29,49,0.591836735,Kings,Sacramento,240,20,24,9,42,51,30,8,11,14,19,126,28
22001025,OKC,1610612760,34,87,0.391,11,37,0.297297297,0.655,23,50,0.46,Thunder,Oklahoma City,240,19,29,10,28,38,23,9,3,14,18,98,-28
22001026,WAS,1610612764,51,100,0.51,13,26,0.5,0.818,38,74,0.513513514,Wizards,Washington,240,9,11,8,34,42,28,8,8,9,21,124,-1
22001026,ATL,1610612737,46,96,0.479,10,30,0.333333333,0.885,36,66,0.545454545,Hawks,Atlanta,240,23,26,13,42,55,23,4,6,12,17,125,1
22001027,IND,1610612754,44,88,0.5,11,27,0.407407407,0.75,33,61,0.540983607,Pacers,Indiana,240,12,16,10,37,47,32,7,13,11,21,111,9
22001027,CLE,1610612739,33,93,0.355,13,39,0.333333333,0.767,20,54,0.37037037,Cavaliers,Cleveland,240,23,30,15,35,50,21,8,2,10,13,102,-9
22001028,NOP,1610612740,43,97,0.443,10,23,0.434782609,0.667,33,74,0.445945946,Pelicans,New Orleans,240,14,21,14,36,50,29,9,4,12,18,110,-5
22001028,MEM,1610612763,45,91,0.495,9,30,0.3,0.593,36,61,0.590163934,Grizzlies,Memphis,240,16,27,10,39,49,33,8,19,10,17,115,5
22001029,SAS,1610612759,56,94,0.596,17,29,0.586206897,0.81,39,65,0.6,Spurs,San Antonio,240,17,21,9,37,46,27,6,5,12,16,146,21
22001029,MIL,1610612749,47,94,0.5,13,41,0.317073171,0.783,34,53,0.641509434,Bucks,Milwaukee,240,18,23,8,26,34,26,6,6,7,13,125,-21
22001030,UTA,1610612762,41,91,0.451,13,44,0.295454545,0.875,28,47,0.595744681,Jazz,Utah,240,21,24,13,35,48,14,7,1,14,20,116,-3
22001030,GSW,1610612744,41,88,0.466,14,42,0.333333333,0.92,27,46,0.586956522,Warriors,Golden State,240,23,25,9,32,41,26,8,2,10,20,119,3
22001031,POR,1610612757,47,92,0.511,18,40,0.45,0.8,29,52,0.557692308,Trail Blazers,Portland,240,28,35,12,35,47,30,7,4,9,18,140,11
22001031,HOU,1610612745,42,85,0.494,18,38,0.473684211,0.964,24,47,0.510638298,Rockets,Houston,240,27,28,7,37,44,30,5,2,13,26,129,-11
22001032,MIA,1610612748,48,81,0.593,16,30,0.533333333,0.773,32,51,0.62745098,Heat,Miami,240,17,22,6,37,43,25,7,4,14,21,129,8
22001032,BOS,1610612738,46,88,0.523,18,37,0.486486486,0.647,28,51,0.549019608,Celtics,Boston,240,11,17,3,29,32,31,8,5,11,21,121,-8
22001033,MIN,1610612750,45,98,0.459,14,48,0.291666667,0.714,31,50,0.62,Timberwolves,Minnesota,240,15,21,11,33,44,30,16,8,15,22,119,19
22001033,DET,1610612765,35,75,0.467,10,23,0.434782609,0.769,25,52,0.480769231,Pistons,Detroit,240,20,26,6,40,46,21,8,5,28,23,100,-19
22001034,TOR,1610612761,35,86,0.407,10,37,0.27027027,0.842,25,49,0.510204082,Raptors,Toronto,240,16,19,9,26,35,21,10,8,13,22,96,-19
22001034,LAC,1610612746,39,78,0.5,11,32,0.34375,1,28,46,0.608695652,Clippers,LA,240,26,26,9,40,49,25,10,4,16,17,115,19
22001035,PHI,1610612755,38,87,0.437,8,26,0.307692308,0.714,30,61,0.491803279,76ers,Philadelphia,240,10,14,5,30,35,23,9,5,11,17,94,-9
22001035,IND,1610612754,37,83,0.446,14,41,0.341463415,0.938,23,42,0.547619048,Pacers,Indiana,240,15,16,7,38,45,28,7,6,13,15,103,9
22001036,CHI,1610612741,39,96,0.406,18,44,0.409090909,0.786,21,52,0.403846154,Bulls,Chicago,240,11,14,10,35,45,21,4,5,9,20,107,-8
22001036,BKN,1610612751,42,89,0.472,12,33,0.363636364,0.76,30,56,0.535714286,Nets,Brooklyn,240,19,25,13,38,51,32,4,8,7,19,115,8
22001037,MEM,1610612763,51,89,0.573,16,33,0.484848485,0.938,35,56,0.625,Grizzlies,Memphis,240,15,16,10,34,44,32,11,6,10,16,133,29
22001037,DAL,1610612742,37,88,0.42,12,38,0.315789474,0.947,25,50,0.5,Mavericks,Dallas,240,18,19,13,22,35,23,8,2,12,15,104,-29
22001038,ORL,1610612753,39,94,0.415,10,30,0.333333333,0.7,29,64,0.453125,Magic,Orlando,240,14,20,10,42,52,18,6,2,12,20,102,-12
22001038,MIL,1610612749,43,101,0.426,8,33,0.242424242,0.741,35,68,0.514705882,Bucks,Milwaukee,240,20,27,17,46,63,16,10,1,9,15,114,12
22001039,PHX,1610612756,41,79,0.519,16,37,0.432432432,0.9,25,42,0.595238095,Suns,Phoenix,240,18,20,6,30,36,26,4,6,10,20,116,-6
22001039,GSW,1610612744,47,95,0.495,11,40,0.275,0.85,36,55,0.654545455,Warriors,Golden State,240,17,20,12,28,40,33,8,1,8,20,122,6
22001040,SAC,1610612758,44,86,0.512,19,39,0.487179487,0.789,25,47,0.531914894,Kings,Sacramento,240,15,19,6,34,40,28,13,6,15,21,122,16
22001040,OKC,1610612760,39,84,0.464,9,23,0.391304348,0.679,30,61,0.491803279,Thunder,Oklahoma City,240,19,28,9,36,45,22,9,5,18,18,106,-16
22001041,NYK,1610612752,34,87,0.391,10,29,0.344827586,0.913,24,58,0.413793103,Knicks,New York,265,21,23,5,36,41,19,8,3,9,21,99,-2
22001041,LAL,1610612747,37,89,0.416,12,28,0.428571429,0.789,25,61,0.409836066,Lakers,Los Angeles,265,15,19,14,39,53,31,5,5,18,17,101,2
22001042,WAS,1610612764,45,101,0.446,10,29,0.344827586,0.842,35,72,0.486111111,Wizards,Washington,240,16,19,9,33,42,29,10,1,7,20,116,-4
22001042,ATL,1610612737,44,86,0.512,10,33,0.303030303,0.786,34,53,0.641509434,Hawks,Atlanta,240,22,28,7,44,51,22,4,5,14,21,120,4
22001043,SAS,1610612759,43,101,0.426,8,31,0.258064516,0.815,35,70,0.5,Spurs,San Antonio,240,22,27,16,30,46,21,7,2,8,19,116,-12
22001043,BKN,1610612751,48,79,0.608,12,28,0.428571429,0.741,36,51,0.705882353,Nets,Brooklyn,240,20,27,3,40,43,33,3,9,11,19,128,12
22001044,CLE,1610612739,36,80,0.45,8,24,0.333333333,0.815,28,56,0.5,Cavaliers,Cleveland,240,22,27,7,48,55,27,4,6,15,13,102,8
22001044,BOS,1610612738,36,101,0.356,12,41,0.292682927,0.714,24,60,0.4,Celtics,Boston,240,10,14,13,33,46,14,9,8,7,23,94,-8
22001045,UTA,1610612762,35,85,0.412,12,40,0.3,0.762,23,45,0.511111111,Jazz,Utah,240,16,21,15,38,53,15,4,4,10,22,98,-7
22001045,POR,1610612757,40,91,0.44,13,32,0.40625,0.706,27,59,0.457627119,Trail Blazers,Portland,240,12,17,9,30,39,17,7,6,5,18,105,7
22001046,LAL,1610612747,52,91,0.571,7,20,0.35,0.591,45,71,0.633802817,Lakers,Los Angeles,240,13,22,8,33,41,28,8,3,11,20,124,2
22001046,HOU,1610612745,43,85,0.506,18,42,0.428571429,0.667,25,43,0.581395349,Rockets,Houston,240,18,27,8,33,41,33,7,4,15,23,122,-2
22001047,LAC,1610612746,40,75,0.533,21,45,0.466666667,0.75,19,30,0.633333333,Clippers,LA,240,12,16,6,38,44,28,6,6,17,17,113,23
22001047,CHA,1610612766,33,84,0.393,9,33,0.272727273,0.789,24,51,0.470588235,Hornets,Charlotte,240,15,19,8,27,35,24,9,1,10,15,90,-23
22001048,MIL,1610612749,54,94,0.574,11,30,0.366666667,0.742,43,64,0.671875,Bucks,Milwaukee,240,23,31,10,41,51,34,5,6,12,10,142,9
22001048,IND,1610612754,50,110,0.455,21,43,0.488372093,0.8,29,67,0.432835821,Pacers,Indiana,240,12,15,12,28,40,34,6,2,7,22,133,-9
22001049,ORL,1610612753,36,94,0.383,11,36,0.305555556,0.667,25,58,0.431034483,Magic,Orlando,240,10,15,16,35,51,24,3,6,14,16,93,-23
22001049,ATL,1610612737,41,94,0.436,14,36,0.388888889,0.833,27,58,0.465517241,Hawks,Atlanta,240,20,24,12,37,49,19,9,4,7,16,116,23
22001050,PHI,1610612755,36,78,0.462,7,25,0.28,0.75,29,53,0.547169811,76ers,Philadelphia,240,15,20,8,22,30,20,8,1,12,18,94,-12
22001050,MIA,1610612748,41,81,0.506,13,35,0.371428571,1,28,46,0.608695652,Heat,Miami,240,11,11,15,32,47,26,5,6,19,15,106,12
22001051,TOR,1610612761,40,90,0.444,12,36,0.333333333,0.556,28,54,0.518518519,Raptors,Toronto,240,10,18,7,25,32,24,16,1,9,14,102,-12
22001051,CHI,1610612741,45,83,0.542,17,36,0.472222222,0.7,28,47,0.595744681,Bulls,Chicago,240,7,10,8,43,51,31,4,4,18,15,114,12
22001052,MIN,1610612750,34,80,0.425,16,41,0.390243902,0.594,18,39,0.461538462,Timberwolves,Minnesota,240,19,32,11,32,43,20,3,5,15,17,103,-11
22001052,DEN,1610612743,46,96,0.479,12,36,0.333333333,0.909,34,60,0.566666667,Nuggets,Denver,240,10,11,14,39,53,30,6,3,12,25,114,11
22001053,POR,1610612757,44,81,0.543,15,33,0.454545455,0.778,29,48,0.604166667,Trail Blazers,Portland,240,14,18,1,32,33,23,7,3,13,18,117,-1
22001053,PHX,1610612756,41,88,0.466,13,32,0.40625,0.885,28,56,0.5,Suns,Phoenix,240,23,26,10,32,42,22,4,3,11,17,118,1
22001054,DET,1610612765,34,83,0.41,6,37,0.162162162,0.739,28,46,0.608695652,Pistons,Detroit,240,17,23,9,32,41,21,6,8,9,13,91,-13
22001054,DEN,1610612743,42,86,0.488,9,32,0.28125,0.786,33,54,0.611111111,Nuggets,Denver,240,11,14,9,40,49,29,6,3,11,17,104,13
22001055,PHI,1610612755,44,93,0.473,16,34,0.470588235,0.947,28,59,0.474576271,76ers,Philadelphia,240,18,19,10,36,46,35,9,8,8,25,122,25
22001055,ORL,1610612753,33,83,0.398,10,30,0.333333333,0.75,23,53,0.433962264,Magic,Orlando,240,21,28,10,34,44,21,4,5,13,15,97,-25
22001056,UTA,1610612762,40,93,0.43,13,39,0.333333333,0.762,27,54,0.5,Jazz,Utah,240,16,21,17,36,53,23,9,3,11,17,109,16
22001056,OKC,1610612760,36,84,0.429,6,19,0.315789474,0.938,30,65,0.461538462,Thunder,Oklahoma City,240,15,16,10,35,45,13,6,2,15,20,93,-16
22001057,TOR,1610612761,42,85,0.494,13,38,0.342105263,0.765,29,47,0.617021277,Raptors,Toronto,240,13,17,4,40,44,19,7,5,11,18,110,-4
22001057,DAL,1610612742,39,90,0.433,17,42,0.404761905,0.905,22,48,0.458333333,Mavericks,Dallas,240,19,21,11,31,42,27,4,3,8,18,114,4
22001058,LAC,1610612746,45,93,0.484,11,35,0.314285714,0.933,34,58,0.586206897,Clippers,LA,240,14,15,7,28,35,29,9,5,13,15,115,-7
22001058,HOU,1610612745,46,86,0.535,14,37,0.378378378,0.727,32,49,0.653061224,Rockets,Houston,240,16,22,8,33,41,30,4,4,15,20,122,7
22001059,NOP,1610612740,46,99,0.465,11,27,0.407407407,0.679,35,72,0.486111111,Pelicans,New Orleans,240,19,28,12,39,51,21,6,3,9,23,122,-3
22001059,GSW,1610612744,42,87,0.483,17,39,0.435897436,0.8,25,48,0.520833333,Warriors,Golden State,240,24,30,8,38,46,29,4,4,11,21,125,3
22001060,CHI,1610612741,34,98,0.347,11,41,0.268292683,0.706,23,57,0.403508772,Bulls,Chicago,240,12,17,19,33,52,24,7,4,9,13,91,-14
22001060,BKN,1610612751,41,87,0.471,14,34,0.411764706,0.6,27,53,0.509433962,Nets,Brooklyn,240,9,15,8,44,52,26,6,8,9,16,105,14
22001061,LAL,1610612747,41,86,0.477,11,29,0.379310345,0.806,30,57,0.526315789,Lakers,Los Angeles,240,29,36,11,34,45,25,5,3,13,15,122,7
22001061,IND,1610612754,46,89,0.517,9,33,0.272727273,0.737,37,56,0.660714286,Pacers,Indiana,240,14,19,8,29,37,28,10,8,13,23,115,-7
22001062,MIL,1610612749,46,86,0.535,13,35,0.371428571,0.708,33,51,0.647058824,Bucks,Milwaukee,240,17,24,5,43,48,29,4,3,11,15,122,14
22001062,MIA,1610612748,40,96,0.417,22,49,0.448979592,0.75,18,47,0.382978723,Heat,Miami,240,6,8,9,29,38,25,8,3,11,18,108,-14
22001063,MIN,1610612750,39,95,0.411,5,37,0.135135135,0.735,34,58,0.586206897,Timberwolves,Minnesota,240,25,34,20,31,51,22,8,7,12,19,108,-16
22001063,BOS,1610612738,46,95,0.484,18,42,0.428571429,0.778,28,53,0.528301887,Celtics,Boston,240,14,18,9,35,44,27,8,6,14,24,124,16
22001064,NYK,1610612752,45,88,0.511,16,37,0.432432432,0.8,29,51,0.568627451,Knicks,New York,265,12,15,7,43,50,29,3,7,9,20,118,9
22001064,CHA,1610612766,39,102,0.382,13,49,0.265306122,0.75,26,53,0.490566038,Hornets,Charlotte,265,18,24,15,36,51,28,5,2,8,18,109,-9
22001065,SAS,1610612759,39,88,0.443,4,26,0.153846154,0.875,35,62,0.564516129,Spurs,San Antonio,240,21,24,7,34,41,23,5,2,16,17,103,-37
22001065,PHX,1610612756,52,94,0.553,15,33,0.454545455,0.955,37,61,0.606557377,Suns,Phoenix,240,21,22,7,40,47,32,10,1,10,15,140,37
22001066,HOU,1610612745,31,92,0.337,18,63,0.285714286,0.75,13,29,0.448275862,Rockets,Houston,240,15,20,11,32,43,25,8,5,15,18,95,-29
22001066,ATL,1610612737,49,90,0.544,7,21,0.333333333,0.731,42,69,0.608695652,Hawks,Atlanta,240,19,26,11,45,56,32,10,8,13,16,124,29
22001067,CLE,1610612739,38,85,0.447,12,39,0.307692308,0.677,26,46,0.565217391,Cavaliers,Cleveland,240,21,31,11,34,45,16,8,5,14,14,109,-14
22001067,BKN,1610612751,47,83,0.566,16,30,0.533333333,0.765,31,53,0.58490566,Nets,Brooklyn,240,13,17,4,33,37,35,9,9,12,20,123,14
22001068,MIL,1610612749,38,90,0.422,12,37,0.324324324,0.75,26,53,0.490566038,Bucks,Milwaukee,240,24,32,10,31,41,14,13,5,11,16,112,-6
22001068,CHI,1610612741,45,87,0.517,14,32,0.4375,0.737,31,55,0.563636364,Bulls,Chicago,240,14,19,8,37,45,23,8,8,16,20,118,6
22001069,MIA,1610612748,47,84,0.56,13,34,0.382352941,0.65,34,50,0.68,Heat,Miami,240,13,20,6,33,39,32,11,5,10,19,120,13
22001069,DET,1610612765,40,86,0.465,11,35,0.314285714,0.727,29,51,0.568627451,Pistons,Detroit,240,16,22,7,26,33,26,4,4,16,21,107,-13
22001070,MEM,1610612763,40,92,0.435,6,25,0.24,0.789,34,67,0.507462687,Grizzlies,Memphis,240,15,19,12,27,39,25,12,5,12,21,101,-12
22001070,GSW,1610612744,41,83,0.494,15,39,0.384615385,0.889,26,44,0.590909091,Warriors,Golden State,240,16,18,12,34,46,26,9,4,19,19,113,12
22001071,MIN,1610612750,49,90,0.544,17,40,0.425,0.84,32,50,0.64,Timberwolves,Minnesota,240,21,25,11,27,38,35,11,4,9,22,136,15
22001071,DAL,1610612742,44,91,0.484,16,38,0.421052632,0.85,28,53,0.528301887,Mavericks,Dallas,240,17,20,11,27,38,32,5,5,16,19,121,-15
22001072,NOP,1610612740,37,78,0.474,9,25,0.36,0.714,28,53,0.528301887,Pelicans,New Orleans,240,15,21,8,39,47,26,4,5,21,18,98,-12
22001072,LAL,1610612747,45,96,0.469,11,35,0.314285714,0.6,34,61,0.557377049,Lakers,Los Angeles,240,9,15,8,34,42,30,14,5,9,16,110,12
22001073,NYK,1610612752,34,79,0.43,13,27,0.481481481,0.789,21,52,0.403846154,Knicks,New York,240,15,19,4,37,41,16,7,6,10,17,96,4
22001073,BOS,1610612738,35,86,0.407,11,41,0.268292683,0.733,24,45,0.533333333,Celtics,Boston,240,11,15,9,37,46,19,4,6,12,19,92,-4
22001074,OKC,1610612760,50,94,0.532,8,26,0.307692308,0.563,42,68,0.617647059,Thunder,Oklahoma City,240,9,16,14,40,54,20,1,12,15,11,117,5
22001074,LAC,1610612746,45,106,0.425,10,43,0.23255814,0.8,35,63,0.555555556,Clippers,LA,240,12,15,16,28,44,17,8,3,3,14,112,-5
22001075,PHI,1610612755,46,94,0.489,19,40,0.475,0.739,27,54,0.5,76ers,Philadelphia,240,17,23,9,32,41,35,8,5,11,27,128,11
22001075,ORL,1610612753,36,76,0.474,10,28,0.357142857,0.854,26,48,0.541666667,Magic,Orlando,240,35,41,9,38,47,23,4,3,16,25,117,-11
22001076,POR,1610612757,46,87,0.529,18,43,0.418604651,0.846,28,44,0.636363636,Trail Blazers,Portland,240,22,26,11,40,51,24,3,6,13,16,132,16
22001076,DEN,1610612743,44,98,0.449,14,37,0.378378378,0.933,30,61,0.491803279,Nuggets,Denver,240,14,15,10,26,36,20,8,2,6,20,116,-16
22001077,UTA,1610612762,41,86,0.477,18,39,0.461538462,0.84,23,47,0.489361702,Jazz,Utah,240,21,25,9,41,50,28,9,3,16,14,121,22
22001077,SAC,1610612758,42,90,0.467,9,30,0.3,0.6,33,60,0.55,Kings,Sacramento,240,6,10,5,34,39,24,10,5,12,22,99,-22
22001078,SAS,1610612759,50,98,0.51,7,24,0.291666667,0.737,43,74,0.581081081,Spurs,San Antonio,240,14,19,11,35,46,30,5,5,10,8,121,-2
22001078,PHX,1610612756,53,104,0.51,13,35,0.371428571,1,40,69,0.579710145,Suns,Phoenix,240,4,4,10,38,48,36,7,5,8,13,123,2
22001079,TOR,1610612761,39,97,0.402,12,38,0.315789474,0.793,27,59,0.457627119,Raptors,Toronto,240,23,29,16,32,48,21,8,3,12,12,113,-12
22001079,IND,1610612754,48,95,0.505,15,37,0.405405405,0.778,33,58,0.568965517,Pacers,Indiana,240,14,18,10,37,47,34,8,3,13,19,125,12
22001080,WAS,1610612764,44,91,0.484,10,31,0.322580645,0.81,34,60,0.566666667,Wizards,Washington,240,17,21,10,43,53,22,4,3,14,20,115,5
22001080,CHA,1610612766,37,94,0.394,14,45,0.311111111,0.917,23,49,0.469387755,Hornets,Charlotte,240,22,24,10,32,42,25,8,5,11,15,110,-5